importance	AAAAB
non	AAAAC
data	AAAAD
touching	AAAAE
processing	AAAAF
overheads	AAAAG
TCP/IP	AAAAH
stochastic	AAAAI
propositionalization	AAAAJ
determinate	AAAAK
background	AAAAL
knowledge	AAAAM
monitoring	AAAAN
diagnosis	AAAAO
continuous	AAAAP
dynamic	AAAAQ
systems	AAAAR
using	AAAAS
semiquantitative	AAAAT
simulation	AAAAU
problem	AAAAV
existence	AAAAW
generation	AAAAX
human	AAAAY
computer	AAAAZ
interface	AAABA
qualitative	AAABB
time	AAABC
scale	AAABD
abstraction	AAABE
reasoning	AAABF
with	AAABG
models	AAABH
quantitative	AAABI
thermodynamics	AAABJ
self	AAABK
delegation	AAABL
controlled	AAABM
propogation	AAABN
loose	AAABO
laptop	AAABP
a	AAABQ
128	AAABR
block	AAABS
cipher	AAABT
approximation	AAABU
algorithms	AAABV
for	AAABW
configuring	AAABX
nonblocking	AAABY
communication	AAABZ
networks	AAACA
structured	AAACB
second	AAACC
higher	AAACD
order	AAACE
derivatives	AAACF
univariate	AAACG
taylor	AAACH
series	AAACI
automatic	AAACJ
differentiation	AAACK
tangent	AAACL
linear	AAACM
pseudo	AAACN
adjoints	AAACO
extending	AAACP
compile	AAACQ
reverse	AAACR
mode	AAACS
exploiting	AAACT
partial	AAACU
separability	AAACV
ADIFOR	AAACW
bucket	AAACX
box	AAACY
intersection	AAACZ
BBI	AAADA
algorithm	AAADB
fast	AAADC
approximative	AAADD
evaluation	AAADE
diagonal	AAADF
mixture	AAADG
gaussians	AAADH
IEEE	AAADI
intl	AAADJ
closed	AAADK
terminologies	AAADL
temporal	AAADM
description	AAADN
logic	AAADO
concept	AAADP
plan	AAADQ
recognition	AAADR
ontological	AAADS
level	AAADT
neural	AAADU
statistical	AAADV
equality	AAADW
elimination	AAADX
semantic	AAADY
tableaux	AAADZ
TextTiling	AAAEA
approach	AAAEB
discourse	AAAEC
segmentation	AAAED
functional	AAAEE
representation	AAAEF
understanding	AAAEG
software	AAAEH
technology	AAAEI
application	AAAEJ
technical	AAAEK
note	AAAEL
formalizing	AAAEM
global	AAAEN
combine	AAAEO
2d	AAAEP
meshes	AAAEQ
wormhole	AAAER
routing	AAAES
pedagogic	AAAET
programming	AAAEU
environment	AAAEV
scheme	AAAEW
integrating	AAAEX
status	AAAEY
event	AAAEZ
phenomena	AAAFA
formal	AAAFB
specifications	AAAFC
interactive	AAAFD
model	AAAFE
based	AAAFF
user	AAAFG
tools	AAAFH
current	AAAFI
state	AAAFJ
declarative	AAAFK
heuristic	AAAFL
guiding	AAAFM
inductive	AAAFN
proofs	AAAFO
feature	AAAFP
face	AAAFQ
distance	AAAFR
vision	AAAFS
pattern	AAAFT
randomised	AAAFU
schema	AAAFV
mutator	AAAFW
evolutionary	AAAFX
database	AAAFY
optimisation	AAAFZ
design	AAAGA
modifications	AAAGB
conceptual	AAAGC
modelling	AAAGD
information	AAAGE
bases	AAAGF
v	AAAGG
implementation	AAAGH
selection	AAAGI
object	AAAGJ
role	AAAGK
t	AAAGL
parallelism	AAAGM
parallel	AAAGN
prolog	AAAGO
semantics	AAAGP
verification	AAAGQ
transformation	AAAGR
populations	AAAGS
operations	AAAGT
internal	AAAGU
reducing	AAAGV
search	AAAGW
space	AAAGX
comparison	AAAGY
schemes	AAAGZ
translating	AAAHA
c	AAAHB
building	AAAHC
reconfiguring	AAAHD
distributed	AAAHE
compensating	AAAHF
reconfiguration	AAAHG
complexity	AAAHH
hajos	AAAHI
calculus	AAAHJ
preliminary	AAAHK
verison	AAAHL
methodology	AAAHM
configuration	AAAHN
behavior	AAAHO
mobile	AAAHP
robots	AAAHQ
path	AAAHR
profile	AAAHS
guided	AAAHT
redundancy	AAAHU
speculation	AAAHV
resource	AAAHW
sensitive	AAAHX
directed	AAAHY
flow	AAAHZ
analysis	AAAIA
code	AAAIB
optimization	AAAIC
side	AAAID
effect	AAAIE
instruction	AAAIF
scheduling	AAAIG
image	AAAIH
digestion	AAAII
relevance	AAAIJ
feedback	AAAIK
ImageRover	AAAIL
WWW	AAAIM
engines	AAAIN
network	AAAIO
effects	AAAIP
prefetching	AAAIQ
replacement	AAAIR
policies	AAAIS
proxy	AAAIT
cache	AAAIU
performance	AAAIV
backup	AAAIW
manager	AAAIX
local	AAAIY
propagation	AAAIZ
inequality	AAAJA
constraints	AAAJB
OTI	AAAJC
constraint	AAAJD
solver	AAAJE
library	AAAJF
constructing	AAAJG
graphical	AAAJH
interfaces	AAAJI
hierarchies	AAAJJ
experience	AAAJK
process	AAAJL
migration	AAAJM
sprite	AAAJN
lambda	AAAJO
loop	AAAJP
toolkit	AAAJQ
reference	AAAJR
manual	AAAJS
value	AAAJT
graph	AAAJU
use	AAAJV
dependence	AAAJW
reduction	AAAJX
array	AAAJY
expressions	AAAJZ
PSI	AAAKA
compiler	AAAKB
spring	AAAKC
nucleus	AAAKD
microkernel	AAAKE
objects	AAAKF
musings	AAAKG
volumetric	AAAKH
detail	AAAKI
virtual	AAAKJ
environments	AAAKK
reality	AAAKL
prediction	AAAKM
intervals	AAAKN
surface	AAAKO
growing	AAAKP
range	AAAKQ
bias	AAAKR
robust	AAAKS
estimation	AAAKT
caused	AAAKU
discontinuities	AAAKV
multiple	AAAKW
structures	AAAKX
group	AAAKY
metacomputing	AAAKZ
architecture	AAALA
authentication	AAALB
method	AAALC
impersonal	AAALD
token	AAALE
cards	AAALF
LaTeX2HTML	AAALG
translator	AAALH
questions	AAALI
answers	AAALJ
bsp	AAALK
conservative	AAALL
garbage	AAALM
collection	AAALN
shared	AAALO
memory	AAALP
rigorous	AAALQ
framework	AAALR
expensive	AAALS
functions	AAALT
surrogates	AAALU
managing	AAALV
multidisciplinary	AAALW
art	AAALX
guide	AAALY
PGAPack	AAALZ
genetic	AAAMA
version	AAAMB
0	AAAMC
rank	AAAMD
ordering	AAAME
positive	AAAMF
rosenberg	AAAMG
1994	AAAMH
balancing	AAAMI
computational	AAAMJ
load	AAAMK
rings	AAAML
processors	AAAMM
adaptive	AAAMN
parameter	AAAMO
pruning	AAAMP
subrahmanian	AAAMQ
video	AAAMR
presentations	AAAMS
finding	AAAMT
structure	AAAMU
abductive	AAAMV
generalised	AAAMW
programs	AAAMX
j	AAAMY
machine	AAAMZ
multicomputer	AAANA
architectural	AAANB
localizing	AAANC
finger	AAAND
probes	AAANE
management	AAANF
quality	AAANG
service	AAANH
case	AAANI
customizable	AAANJ
abstract	AAANK
interpretation	AAANL
partition	AAANM
refinement	AAANN
checking	AAANO
scalable	AAANP
geometric	AAANQ
problems	AAANR
computing	AAANS
medial	AAANT
axis	AAANU
transform	AAANV
8	AAANW
scan	AAANX
experiments	AAANY
multistrategy	AAANZ
learning	AAAOA
meta	AAAOB
interval	AAAOC
classifier	AAAOD
mining	AAAOE
applications	AAAOF
geometry	AAAOG
optimal	AAAOH
implications	AAAOI
family	AAAOJ
irregular	AAAOK
optimality	AAAOL
domination	AAAOM
repeated	AAAON
games	AAAOO
bounded	AAAOP
players	AAAOQ
efficient	AAAOR
play	AAAOS
computationally	AAAOT
adversaries	AAAOU
new	AAAOV
i/o	AAAOW
EvaluationSelf	AAAOX
scaling	AAAOY
benchmarks	AAAOZ
predicted	AAAPA
thread	AAAPB
implicit	AAAPC
explicit	AAAPD
techniques	AAAPE
portable	AAAPF
threads	AAAPG
packages	AAAPH
potential	AAAPI
networking	AAAPJ
positioning	AAAPK
GPS	AAAPL
end	AAAPM
transport	AAAPN
protocol	AAAPO
alternative	AAAPP
wireless	AAAPQ
links	AAAPR
analog	AAAPS
computation	AAAPT
personal	AAAPU
agent	AAAPV
world	AAAPW
wide	AAAPX
web	AAAPY
browsing	AAAPZ
searching	AAAQA
evolving	AAAQB
multi	AAAQC
filtering	AAAQD
solution	AAAQE
amalthea	AAAQF
deriving	AAAQG
response	AAAQH
bounds	AAAQI
equational	AAAQJ
rule	AAAQK
hierarchical	AAAQL
navigation	AAAQM
querying	AAAQN
ACM	AAAQO
multimedia	AAAQP
workshop	AAAQQ
effective	AAAQR
abstractions	AAAQS
layout	AAAQT
presentation	AAAQU
interaction	AAAQV
caching	AAAQW
file	AAAQX
aint	AAAQY
nuthin	AAAQZ
but	AAARA
trash	AAARB
capturing	AAARC
connectivity	AAARD
high	AAARE
dimensional	AAARF
spaces	AAARG
parallelizable	AAARH
random	AAARI
sampling	AAARJ
causal	AAARK
ip	AAARL
multicasting	AAARM
hosts	AAARN
prototyping	AAARO
proteus	AAARP
usage	AAARQ
area	AAARR
system	AAARS
geocast	AAART
geographic	AAARU
address	AAARV
ing	AAARW
fault	AAARX
tolerant	AAARY
hot	AAARZ
replication	AAASA
extraction	AAASB
restrict	AAASC
hypothesis	AAASD
ILP	AAASE
dietterich	AAASF
1991	AAASG
irrelevant	AAASH
features	AAASI
preserving	AAASJ
reducibility	AAASK
closure	AAASL
representations	AAASM
presence	AAASN
malicious	AAASO
errors	AAASP
page	AAASQ
learnability	AAASR
universal	AAASS
study	AAAST
production	AAASU
cell	AAASV
PROMELA	AAASW
SPIN	AAASX
classification	AAASY
weak	AAASZ
theory	AAATA
domains	AAATB
reactivity	AAATC
robot	AAATD
specifying	AAATE
communicative	AAATF
ConGolog	AAATG
synthesizing	AAATH
customized	AAATI
plans	AAATJ
generalized	AAATK
consensus	AAATL
minimization	AAATM
boolean	AAATN
experienced	AAATO
deductive	AAATP
acquisition	AAATQ
hyponyms	AAATR
large	AAATS
text	AAATT
corpora	AAATU
issues	AAATV
belief	AAATW
wootters	AAATX
fine	AAATY
grain	AAATZ
producer	AAAUA
initiated	AAAUB
coherent	AAAUC
multiprocessors	AAAUD
motion	AAAUE
color	AAAUF
animat	AAAUG
perception	AAAUH
center	AAAUI
research	AAAUJ
form	AAAUK
ramification	AAAUL
log	AAAUM
polynomial	AAAUN
choice	AAAUO
wavelets	AAAUP
compression	AAAUQ
computations	AAAUR
introduction	AAAUS
uses	AAAUT
resources	AAAUU
validated	AAAUV
solutions	AAAUW
initial	AAAUX
ordinary	AAAUY
differential	AAAUZ
equations	AAAVA
server	AAAVB
impact	AAAVC
placement	AAAVD
OODBMS	AAAVE
simulating	AAAVF
quadratic	AAAVG
dynamical	AAAVH
is	AAAVI
pspace	AAAVJ
complete	AAAVK
improving	AAAVL
solving	AAAVM
mixed	AAAVN
boundary	AAAVO
ODEs	AAAVP
MarketSpace	AAAVQ
open	AAAVR
market	AAAVS
infrastructure	AAAVT
checkpoint	AAAVU
entry	AAAVV
consistent	AAAVW
leveled	AAAVX
commitment	AAAVY
protocols	AAAVZ
automated	AAAWA
negotiation	AAAWB
empirical	AAAWC
heterogeneity	AAAWD
stability	AAAWE
efficiency	AAAWF
distributedsystems	AAAWG
java	AAAWH
InfoSleuth	AAAWI
exploitation	AAAWJ
heterogeneous	AAAWK
ressources	AAAWL
beyond	AAAWM
logical	AAAWN
implication	AAAWO
content	AAAWP
servers	AAAWQ
WAIS	AAAWR
broker	AAAWS
sorting	AAAWT
queries	AAAWU
availability	AAAWV
operating	AAAWW
review	AAAWX
quorum	AAAWY
concensus	AAAWZ
partitioning	AAAXA
key	AAAXB
nothing	AAAXC
price	AAAXD
techni	AAAXE
cal	AAAXF
report	AAAXG
parallelizing	AAAXH
molecular	AAAXI
dynamics	AAAXJ
codes	AAAXK
parti	AAAXL
primitives	AAAXM
associative	AAAXN
query	AAAXO
answering	AAAXP
look	AAAXQ
ahead	AAAXR
satisfaction	AAAXS
sparse	AAAXT
perceptrons	AAAXU
reduce	AAAXV
reuse	AAAXW
recycle	AAAXX
internet	AAAXY
caches	AAAXZ
predictive	AAAYA
hoarding	AAAYB
disconnected	AAAYC
operation	AAAYD
maintaining	AAAYE
strong	AAAYF
consistency	AAAYG
accessing	AAAYH
nearby	AAAYI
copies	AAAYJ
replicated	AAAYK
leases	AAAYL
support	AAAYM
driven	AAAYN
source	AAAYO
ad	AAAYP
hoc	AAAYQ
sim94	AAAYR
concurrent	AAAYS
simulator	AAAYT
troops	AAAYU
locality	AAAYV
methods	AAAYW
evolve	AAAYX
legal	AAAYY
phenotypes	AAAYZ
desiderata	AAAZA
languages	AAAZB
phenes	AAAZC
baldwin	AAAZD
evolution	AAAZE
simulated	AAAZF
population	AAAZG
machines	AAAZH
optimizing	AAAZI
distributions	AAAZJ
discovering	AAAZK
attribute	AAAZL
databases	AAAZM
symbolic	AAAZN
relational	AAAZO
computable	AAAZP
upholding	AAAZQ
maxim	AAAZR
during	AAAZS
patient	AAAZT
centered	AAAZU
activities	AAAZV
facilitating	AAAZW
worst	AAAZX
execution	AAAZY
optimized	AAAZZ
ajanta	AABAA
protected	AABAB
access	AABAC
XSB	AABAD
programmer	AABAE
1	AABAF
persistent	AABAG
drift	AABAH
trainability	AABAI
single	AABAJ
neurons	AABAK
speed	AABAL
complex	AABAM
values	AABAN
infinite	AABAO
BSD	AABAP
packet	AABAQ
filter	AABAR
capture	AABAS
underlying	AABAT
magic	AABAU
templates	AABAV
tabulation	AABAW
quantifiers	AABAX
switching	AABAY
cerebellar	AABAZ
movement	AABBA
control	AABBB
FM96	AABBC
electronic	AABBD
auction	AABBE
house	AABBF
register	AABBG
considerations	AABBH
dynamically	AABBI
scheduled	AABBJ
conferencing	AABBK
testbed	AABBL
ATM	AABBM
optimizations	AABBN
discovery	AABBO
association	AABBP
rules	AABBQ
sensor	AABBR
planning	AABBS
hyper	AABBT
redundant	AABBU
manipulator	AABBV
cost	AABBW
trilinearity	AABBX
three	AABBY
perspective	AABBZ
views	AABCA
associated	AABCB
tensor	AABCC
camera	AABCD
calibration	AABCE
rotation	AABCF
shapes	AABCG
product	AABCH
formulation	AABCI
strassen	AABCJ
matrix	AABCK
multiplication	AABCL
algebra	AABCM
inter	AABCN
domain	AABCO
topology	AABCP
route	AABCQ
polyhedral	AABCR
gain	AABCS
landscapes	AABCT
costs	AABCU
assimilation	AABCV
input	AABCW
stabilizability	AABCX
parameterized	AABCY
families	AABCZ
supervised	AABDA
conditional	AABDB
trading	AABDC
limits	AABDD
sensors	AABDE
royal	AABDF
road	AABDG
fitness	AABDH
adapter	AABDI
integrated	AABDJ
diagnostic	AABDK
combining	AABDL
usefulness	AABDM
reusing	AABDN
variables	AABDO
bayesian	AABDP
intelligent	AABDQ
retrieval	AABDR
synergistic	AABDS
CBR	AABDT
ir	AABDU
constructions	AABDV
neighborhood	AABDW
covers	AABDX
sequential	AABDY
critical	AABDZ
decision	AABEA
making	AABEB
predictable	AABEC
demands	AABED
deliberation	AABEE
flexible	AABEF
practical	AABEG
bridge	AABEH
location	AABEI
independent	AABEJ
agents	AABEK
two	AABEL
integration	AABEM
graphs	AABEN
class	AABEO
decidable	AABEP
hybrid	AABEQ
r	AABER
intractability	AABES
reachability	AABET
3d	AABEU
visit	AABEV
once	AABEW
piecewise	AABEX
constant	AABEY
derivative	AABEZ
language	AABFA
handling	AABFB
exceptions	AABFC
designing	AABFD
phase	AABFE
nonlinear	AABFF
toolbox	AABFG
maglev	AABFH
survey	AABFI
multilingual	AABFJ
ill	AABFK
posed	AABFL
complementarity	AABFM
anticipating	AABFN
forestalling	AABFO
failures	AABFP
reactive	AABFQ
profiling	AABFR
program	AABFS
classifying	AABFT
protein	AABFU
segments	AABFV
transmembrane	AABFW
patterns	AABFX
unix	AABFY
traces	AABFZ
intrusion	AABGA
detection	AABGB
mesh	AABGC
torus	AABGD
chaotic	AABGE
minimal	AABGF
permutations	AABGG
appear	AABGH
queue	AABGI
size	AABGJ
organization	AABGK
clients	AABGL
goal	AABGM
oriented	AABGN
buffer	AABGO
revisited	AABGP
supporting	AABGQ
transaction	AABGR
charasteristics	AABGS
impacts	AABGT
job	AABGU
mix	AABGV
sharing	AABGW
schedulers	AABGX
crisis	AABGY
task	AABGZ
lazy	AABHA
debugger	AABHB
modeling	AABHC
uncertain	AABHD
i	AABHE
probabilistic	AABHF
change	AABHG
mice	AABHH
coordination	AABHI
term	AABHJ
clustering	AABHK
syntactic	AABHL
phrases	AABHM
attributed	AABHN
AEow	AABHO
parsing	AABHP
recognize	AABHQ
clichs	AABHR
tables	AABHS
should	AABHT
be	AABHU
sorted	AABHV
overlapping	AABHW
transfer	AABHX
strict	AABHY
characteristics	AABHZ
desktop	AABIA
windows	AABIB
nt	AABIC
type	AABID
initialization	AABIE
bytecode	AABIF
combined	AABIG
BIT	AABIH
TIMESTAMP	AABII
list	AABIJ
update	AABIK
accessible	AABIL
newswire	AABIM
generating	AABIN
natural	AABIO
summaries	AABIP
online	AABIQ
sources	AABIR
gene	AABIS
sequence	AABIT
embedded	AABIU
validation	AABIV
synthesis	AABIW
grasp	AABIX
visual	AABIY
recursive	AABIZ
cassowary	AABJA
arithmetic	AABJB
correction	AABJC
reiter	AABJD
least	AABJE
strategy	AABJF
transitions	AABJG
properties	AABJH
CP95	AABJI
studying	AABJJ
really	AABJK
hard	AABJL
weld	AABJM
experiences	AABJN
mactester	AABJO
science	AABJP
engineering	AABJQ
education	AABJR
timing	AABJS
max	AABJT
retiming	AABJU
pipelining	AABJV
latency	AABJW
constrained	AABJX
circuits	AABJY
multicast	AABJZ
error	AABKA
packetized	AABKB
voice	AABKC
band	AABKD
width	AABKE
stream	AABKF
distribution	AABKG
vetterli	AABKH
receiver	AABKI
layered	AABKJ
revision	AABKK
module	AABKL
difficulty	AABKM
noise	AABKN
reliable	AABKO
RMTP	AABKP
disk	AABKQ
subsystem	AABKR
striping	AABKS
vs	AABKT
conventional	AABKU
DATAMAN	AABKV
project	AABKW
mosaic	AABKX
dependant	AABKY
evaluating	AABKZ
architectures	AABLA
threaded	AABLB
CORBA	AABLC
request	AABLD
brokers	AABLE
developing	AABLF
C++	AABLG
servant	AABLH
classes	AABLI
priority	AABLJ
inversion	AABLK
determinism	AABLL
real	AABLM
audio	AABLN
streaming	AABLO
patience	AABLP
virtue	AABLQ
slack	AABLR
competitiveness	AABLS
admission	AABLT
collector	AABLU
lifetimes	AABLV
uncertainty	AABLW
failure	AABLX
specification	AABLY
iterators	AABLZ
swapping	AABMA
paradigm	AABMB
topological	AABMC
useful	AABMD
rewriting	AABME
concurrency	AABMF
progress	AABMG
mechanized	AABMH
prospects	AABMI
refactoring	AABMJ
frameworks	AABMK
z	AABML
substrate	AABMM
style	AABMN
logics	AABMO
power	AABMP
simplicity	AABMQ
FACTS	AABMR
resolution	AABMS
coding	AABMT
transmission	AABMU
imaging	AABMV
assistant	AABMW
regression	AABMX
match	AABMY
weight	AABMZ
collaboration	AABNA
adapted	AABNB
dirichlet	AABNC
priors	AABND
derive	AABNE
hidden	AABNF
markov	AABNG
kolmogorov	AABNH
sets	AABNI
oracle	AABNJ
false	AABNK
alignments	AABNL
atmospheric	AABNM
dis	AABNN
14SCIRun	AABNO
dispersion	AABNP
unstructured	AABNQ
persion	AABNR
grid	AABNS
environmental	AABNT
assessment	AABNU
noisy	AABNV
situation	AABNW
automata	AABNX
theoretic	AABNY
mutation	AABNZ
alignment	AABOA
antipodal	AABOB
layers	AABOC
ZLIB	AABOD
compressed	AABOE
format	AABOF
3	AABOG
modularity	AABOH
timed	AABOI
localization	AABOJ
articulated	AABOK
checker	AABOL
expressive	AABOM
clocks	AABON
trees	AABOO
coreference	AABOP
measuring	AABOQ
forensic	AABOR
bayes	AABOS
semi	AABOT
discrete	AABOU
decomposition	AABOV
latent	AABOW
indexing	AABOX
speaker	AABOY
identification	AABOZ
telephone	AABPA
channels	AABPB
are	AABPC
arm	AABPD
trajectories	AABPE
planned	AABPF
kinematic	AABPG
coordinates	AABPH
adaptation	AABPI
experimental	AABPJ
brain	AABPK
press	AABPL
correlation	AABPM
refining	AABPN
estimates	AABPO
busy	AABPP
idle	AABPQ
profiles	AABPR
compact	AABPS
interleaved	AABPT
overlapped	AABPU
tasks	AABPV
collaborative	AABPW
replayable	AABPX
workspaces	AABPY
registration	AABPZ
frameless	AABQA
stereotaxy	AABQB
surgery	AABQC
enhanced	AABQD
visualization	AABQE
vapnik	AABQF
chervonenkis	AABQG
dimension	AABQH
nets	AABQI
handbook	AABQJ
connectionist	AABQK
probability	AABQL
DECIPHE	AABQM
peech	AABQN
ideas	AABQO
selecting	AABQP
invited	AABQQ
manipulators	AABQR
mathematics	AABQS
privacy	AABQT
security	AABQU
move	AABQV
indirect	AABQW
kerberos	AABQX
session	AABQY
draft	AABQZ
documents	AABRA
sequences	AABRB
loss	AABRC
USC	AABRD
stub	AABRE
split	AABRF
menus	AABRG
effectively	AABRH
frequency	AABRI
organize	AABRJ
kahng	AABRK
recent	AABRL
directions	AABRM
netlist	AABRN
reinforcement	AABRO
cybernetic	AABRP
slot	AABRQ
allocation	AABRR
messages	AABRS
negotiable	AABRT
toussaint	AABRU
intelligibility	AABRV
duality	AABRW
principle	AABRX
threshold	AABRY
gates	AABRZ
mul	AABSA
ticasting	AABSB
ack	AABSC
expressively	AABSD
mazurkiewicz	AABSE
imposing	AABSF
unified	AABSG
rapid	AABSH
technique	AABSI
burst	AABSJ
static	AABSK
typing	AABSL
regularity	AABSM
=	AABSN
types	AABSO
axiomatic	AABSP
proof	AABSQ
gentle	AABSR
2	AABSS
shortest	AABST
paths	AABSU
sum	AABSV
pairs	AABSW
practice	AABSX
composite	AABSY
stock	AABSZ
cutting	AABTA
nealing	AABTB
derivation	AABTC
detecting	AABTD
scheduler	AABTE
CHANGELING	AABTF
executable	AABTG
assertions	AABTH
tolerance	AABTI
branch	AABTJ
bound	AABTK
derived	AABTL
proceedings	AABTM
16th	AABTN
international	AABTO
COMPSAC	AABTP
varieties	AABTQ
participation	AABTR
co	AABTS
social	AABTT
activity	AABTU
humans	AABTV
schooling	AABTW
together	AABTX
assessing	AABTY
hypertext	AABTZ
hypermedia	AABUA
improved	AABUB
deducing	AABUC
relevant	AABUD
disclosure	AABUE
index	AABUF
enhancement	AABUG
occlusion	AABUH
transparency	AABUI
heuristics	AABUJ
blackboard	AABUK
analyzing	AABUL
relationship	AABUM
190	AABUN
MHz	AABUO
CMOS	AABUP
4	AABUQ
kbyte	AABUR
pipelined	AABUS
game	AABUT
dots	AABUU
boxes	AABUV
planner	AABUW
tutors	AABUX
explanatory	AABUY
simulations	AABUZ
improve	AABVA
specialized	AABVB
procedures	AABVC
runtime	AABVD
string	AABVE
putting	AABVF
fill	AABVG
unit	AABVH
work	AABVI
trace	AABVJ
microprocessors	AABVK
partially	AABVL
safe	AABVM
buffers	AABVN
point	AABVO
tracking	AABVP
assumption	AABVQ
football	AABVR
gallium	AABVS
arsenide	AABVT
RISC	AABVU
microprocessor	AABVV
example	AABVW
characterization	AABVX
spatial	AABVY
thickness	AABVZ
variations	AABWA
lpcvd	AABWB
oxide	AABWC
tutorial	AABWD
PVS	AABWE
zone	AABWF
inverse	AABWG
diffusion	AABWH
silicon	AABWI
p4	AABWJ
unwinding	AABWK
inference	AABWL
action	AABWM
grained	AABWN
slicing	AABWO
speech	AABWP
perceptual	AABWQ
auditory	AABWR
integrity	AABWS
remote	AABWT
chain	AABWU
polylog	AABWV
n=lg	AABWW
n	AABWX
basis	AABWY
collaborations	AABWZ
predicting	AABXA
active	AABXB
that	AABXC
reasons	AABXD
collections	AABXE
things	AABXF
modular	AABXG
SRT	AABXH
division	AABXI
acknowledgments	AABXJ
this	AABXK
has	AABXL
been	AABXM
conducted	AABXN
visiting	AABXO
SRI	AABXP
merge	AABXQ
purge	AABXR
sense	AABXS
selectively	AABXT
physical	AABXU
datatypes	AABXV
valued	AABXW
xof	AABXX
attributes	AABXY
versus	AABXZ
nominal	AABYA
constructive	AABYB
induction	AABYC
different	AABYD
matching	AABYE
misuse	AABYF
RADIUS	AABYG
common	AABYH
development	AABYI
parametric	AABYJ
polymorphism	AABYK
quantifying	AABYL
differences	AABYM
SELF	AABYN
typed	AABYO
prototypes	AABYP
BDI	AABYQ
delta	AABYR
comparisons	AABYS
CHC	AABYT
SGA	AABYU
GENITOR	AABYV
hill	AABYW
climbing	AABYX
polymorphic	AABYY
inline	AABYZ
reconciling	AABZA
exploratory	AABZB
generative	AABZC
handwritten	AABZD
digit	AABZE
configurations	AABZF
binomial	AABZG
negation	AABZH
HiLog	AABZI
schedules	AABZJ
hop	AABZK
WDM	AABZL
transition	AABZM
training	AABZN
asr	AABZO
monads	AABZP
1995	AABZQ
body	AABZR
gestures	AABZS
developments	AABZT
complementary	AABZU
discrimination	AABZV
lists	AABZW
structural	AABZX
descriptions	AABZY
examples	AABZZ
topic	AACAA
strongly	AACAB
cooperation	AACAC
strategies	AACAD
lower	AACAE
circuit	AACAF
depth	AACAG
cooperative	AACAH
coaching	AACAI
matcher	AACAJ
traffic	AACAK
similarity	AACAL
tcp	AACAM
imagery	AACAN
salience	AACAO
locative	AACAP
context	AACAQ
meeting	AACAR
results	AACAS
expect	AACAT
aids	AACAU
horn	AACAV
clause	AACAW
theories	AACAX
reflection	AACAY
principles	AACAZ
reusable	AACBA
components	AACBB
classify	AACBC
monitor	AACBD
site	AACBE
paradigms	AACBF
amorphous	AACBG
eOEcient	AACBH
simulators	AACBI
speciocation	AACBJ
pe	AACBK
formance	AACBL
relevancy	AACBM
p	AACBN
proach	AACBO
iterative	AACBP
combinatorial	AACBQ
polygonal	AACBR
direct	AACBS
scalar	AACBT
volume	AACBU
rendering	AACBV
hardware	AACBW
assisted	AACBX
grids	AACBY
incremental	AACBZ
compressionless	AACCA
independently	AACCB
developed	AACCC
easy	AACCD
line	AACCE
trans	AACCF
mortgage	AACCG
pool	AACCH
free	AACCI
derandomized	AACCJ
products	AACCK
deadlock	AACCL
freedom	AACCM
asynchronous	AACCN
interactions	AACCO
chosen	AACCP
attack	AACCQ
verifying	AACCR
cryptographic	AACCS
signal	AACCT
buffered	AACCU
clock	AACCV
lagrangian	AACCW
relaxation	AACCX
signals	AACCY
approximating	AACCZ
minimum	AACDA
cuts	AACDB
insertions	AACDC
simultaneous	AACDD
insertion	AACDE
wire	AACDF
sizing	AACDG
spanning	AACDH
planar	AACDI
rate	AACDJ
m	AACDK
workload	AACDL
multithreaded	AACDM
neutral	AACDN
FORTRAN	AACDO
prioritized	AACDP
defaults	AACDQ
parameters	AACDR
tradeoff	AACDS
conditioning	AACDT
tool	AACDU
SVM	AACDV
jade	AACDW
dominating	AACDX
set	AACDY
tournament	AACDZ
fundamental	AACEA
future	AACEB
providing	AACEC
switched	AACED
grammars	AACEE
extension	AACEF
wanted	AACEG
know	AACEH
rigid	AACEI
e	AACEJ
unification	AACEK
undecidable	AACEL
related	AACEM
herbrand	AACEN
theorem	AACEO
intuitionistic	AACEP
taught	AACEQ
visually	AACER
pointing	AACES
humanoid	AACET
word	AACEU
disambiguation	AACEV
lexical	AACEW
cues	AACEX
telicity	AACEY
realization	AACEZ
translation	AACFA
english	AACFB
verb	AACFC
alternations	AACFD
overview	AACFE
galerkin	AACFF
radiosity	AACFG
higer	AACFH
illumination	AACFI
estimating	AACFJ
factors	AACFK
via	AACFL
posterior	AACFM
laplace	AACFN
metropolis	AACFO
estimator	AACFP
simplifying	AACFQ
sensory	AACFR
motor	AACFS
robotic	AACFT
compacting	AACFU
heap	AACFV
quasi	AACFW
synchronous	AACFX
checkpointing	AACFY
pointer	AACFZ
aliasing	AACGA
fragment	AACGB
preprocessing	AACGC
conditions	AACGD
european	AACGE
flows	AACGF
GSAT	AACGG
tests	AACGH
concepts	AACGI
decentralized	AACGJ
trust	AACGK
PLAN	AACGL
introducing	AACGM
services	AACGN
acquiring	AACGO
mapping	AACGP
meaning	AACGQ
sounds	AACGR
connection	AACGS
substitutions	AACGT
preserves	AACGU
normalization	AACGV
multidimensional	AACGW
binary	AACGX
used	AACGY
gaps	AACGZ
assembly	AACHA
requirements	AACHB
avionics	AACHC
milli	AACHD
air	AACHE
bearing	AACHF
deliberative	AACHG
dialogue	AACHH
agency	AACHI
cases	AACHJ
unnormalized	AACHK
exponential	AACHL
actions	AACHM
top	AACHN
gaze	AACHO
targeting	AACHP
variant	AACHQ
wait	AACHR
chernoff	AACHS
hoeffding	AACHT
limited	AACHU
independence	AACHV
lateral	AACHW
controllers	AACHX
stereo	AACHY
drive	AACHZ
vehicles	AACIA
nonholonomic	AACIB
brains	AACIC
rooms	AACID
personalized	AACIE
congestion	AACIF
do	AACIG
right	AACIH
thing	AACII
codec	AACIJ
variational	AACIK
inequalities	AACIL
GAMS	AACIM
expressing	AACIN
communicating	AACIO
solvers	AACIP
PAR	AACIQ
libraries	AACIR
computers	AACIS
algorithmic	AACIT
redistribution	AACIU
cyclic	AACIV
decompositions	AACIW
factorial	AACIX
em	AACIY
decipline	AACIZ
communications	AACJA
platform	AACJB
playout	AACJC
dataflow	AACJD
synthetic	AACJE
aperture	AACJF
radar	AACJG
guarantees	AACJH
varying	AACJI
times	AACJJ
fractals	AACJK
secondary	AACJL
ATOMIC	AACJM
informing	AACJN
modern	AACJO
hierarchically	AACJP
cube	AACJQ
forests	AACJR
OLAP	AACJS
aggregation	AACJT
aggregates	AACJU
low	AACJV
contention	AACJW
linearizable	AACJX
counting	AACJY
pixels	AACJZ
modal	AACKA
mu	AACKB
passing	AACKC
processes	AACKD
adders	AACKE
incorporating	AACKF
procedural	AACKG
measures	AACKH
generated	AACKI
images	AACKJ
predictors	AACKK
accuracy	AACKL
switches	AACKM
fetch	AACKN
issue	AACKO
implementable	AACKP
multithread	AACKQ
processor	AACKR
headers	AACKS
approaches	AACKT
increasing	AACKU
demultiplexing	AACKV
interprocedural	AACKW
general	AACKX
bottom	AACKY
precise	AACKZ
chopping	AACLA
throughput	AACLB
tradeoffs	AACLC
pipelines	AACLD
shuttle	AACLE
reaction	AACLF
relations	AACLG
pathfinding	AACLH
anonymity	AACLI
variable	AACLJ
protection	AACLK
travelling	AACLL
incognito	AACLM
users	AACLN
identity	AACLO
synchronization	AACLP
overhead	AACLQ
massively	AACLR
first	AACLS
diffusive	AACLT
coarse	AACLU
coordinating	AACLV
multiagent	AACLW
behaviors	AACLX
yacc	AACLY
another	AACLZ
supplementary	AACMA
grapheme	AACMB
phoneme	AACMC
conversion	AACMD
customizing	AACME
controlling	AACMF
rt	AACMG
mach	AACMH
signatures	AACMI
subtype	AACMJ
proposal	AACMK
race	AACML
accesses	AACMM
sufficient	AACMN
implementing	AACMO
finite	AACMP
datalog	AACMQ
transducers	AACMR
SVP	AACMS
streams	AACMT
preferences	AACMU
fourth	AACMV
german	AACMW
REPRO	AACMX
flowsheet	AACMY
extended	AACMZ
well	AACNA
founded	AACNB
negations	AACNC
id	AACND
metallic	AACNE
patinas	AACNF
particles	AACNG
sample	AACNH
surfaces	AACNI
minimized	AACNJ
tree	AACNK
small	AACNL
disjuncts	AACNM
benefit	AACNN
biases	AACNO
function	AACNP
averaging	AACNQ
map	AACNR
episodic	AACNS
lattice	AACNT
CLARE	AACNU
sphere	AACNV
packing	AACNW
coarsening	AACNX
delaunay	AACNY
community	AACNZ
climate	AACOA
operator	AACOB
generalizing	AACOC
sound	AACOD
sensing	AACOE
advances	AACOF
contin	AACOG
uous	AACOH
c4	AACOI
composable	AACOJ
toward	AACOK
mid	AACOL
dleware	AACOM
timers	AACON
soft	AACOO
act	AACOP
shear	AACOQ
warp	AACOR
factorization	AACOS
viewing	AACOT
frame	AACOU
thrashless	AACOV
ray	AACOW
casting	AACOX
advancing	AACOY
traversal	AACOZ
visualizing	AACPA
colossal	AACPB
medical	AACPC
volumes	AACPD
biomedical	AACPE
template	AACPF
grouping	AACPG
renderers	AACPH
fluid	AACPI
coalition	AACPJ
cryptography	AACPK
mechanisms	AACPL
formation	AACPM
physics	AACPN
mutual	AACPO
exclusion	AACPP
uniprocessors	AACPQ
dependencies	AACPR
classifiers	AACPS
completeness	AACPT
recover	AACPU
efficiently	AACPV
asynchronously	AACPW
optimism	AACPX
fail	AACPY
experimentation	AACPZ
forgetting	AACQA
configurable	AACQB
motivation	AACQC
dictionary	AACQD
construction	AACQE
spot	AACQF
elf	AACQG
definition	AACQH
verified	AACQI
metaprogramming	AACQJ
fading	AACQK
part	AACQL
polymatroidal	AACQM
capacities	AACQN
disjunctive	AACQO
autoepistemic	AACQP
explanation	AACQQ
embracing	AACQR
causality	AACQS
means	AACQT
combinarotial	AACQU
algebraic	AACQV
quantifier	AACQW
release	AACQX
separating	AACQY
kinematics	AACQZ
stewart	AACRA
gough	AACRB
platforms	AACRC
selected	AACRD
biology	AACRE
robotics	AACRF
simplified	AACRG
endoscopy	AACRH
synchronisation	AACRI
periodic	AACRJ
determining	AACRK
planes	AACRL
un	AACRM
examination	AACRN
MBone	AACRO
UCL	AACRP
ISI	AACRQ
comprehensive	AACRR
triangulation	AACRS
measurement	AACRT
tridimensional	AACRU
pixel	AACRV
detector	AACRW
capacitance	AACRX
os	AACRY
NonDestructive	AACRZ
inspector	AACSA
aging	AACSB
aircraft	AACSC
skins	AACSD
pairwise	AACSE
derandomization	AACSF
atomicity	AACSG
events	AACSH
animations	AACSI
PARADE	AACSJ
executions	AACSK
acceptable	AACSL
metrics	AACSM
preference	AACSN
simple	AACSO
IRAM	AACSP
existing	AACSQ
designs	AACSR
implemented	AACSS
vehicleslook	AACST
delay	AACSU
memo	AACSV
stereopsis	AACSW
lane	AACSX
RELIEFF	AACSY
hashing	AACSZ
can	AACTA
simplify	AACTB
zero	AACTC
bit	AACTD
interpolative	AACTE
d/a	AACTF
converters	AACTG
a/d	AACTH
navigating	AACTI
catalog	AACTJ
convex	AACTK
tours	AACTL
ANSI	AACTM
sliced	AACTN
signature	AACTO
files	AACTP
call	AACTQ
micropayment	AACTR
compilation	AACTS
HPSG	AACTT
TAG	AACTU
parameterizable	AACTV
expansion	AACTW
formalisms	AACTX
backbone	AACTY
mbone	AACTZ
delivery	AACUA
pages	AACUB
best	AACUC
effort	AACUD
UDP	AACUE
approximate	AACUF
duplication	AACUG
studies	AACUH
intron	AACUI
genetics	AACUJ
undecidability	AACUK
reading	AACUL
nqthm	AACUM
output	AACUN
gate	AACUO
VHDL	AACUP
transitive	AACUQ
shostaks	AACUR
combinations	AACUS
infopad	AACUT
deduction	AACUU
vc	AACUV
sigmoidal	AACUW
pfaffian	AACUX
fair	AACUY
EEG	AACUZ
devices	AACVA
extensions	AACVB
rationale	AACVC
pure	AACVD
cecil	AACVE
selective	AACVF
recompilation	AACVG
intermodule	AACVH
reflections	AACVI
TREC	AACVJ
predicate	AACVK
risk	AACVL
depending	AACVM
synchronized	AACVN
preventing	AACVO
denial	AACVP
forgery	AACVQ
relationships	AACVR
sextant	AACVS
piranha	AACVT
sather	AACVU
message	AACVV
one	AACVW
way	AACVX
hash	AACVY
needs	AACVZ
learned	AACWA
kindergarten	AACWB
negotiating	AACWC
sequoia	AACWD
2000	AACWE
addresses	AACWF
terrains	AACWG
height	AACWH
fields	AACWI
procedure	AACWJ
coloring	AACWK
SIGPLAN	AACWL
conference	AACWM
manipulation	AACWN
contact	AACWO
ubiquitous	AACWP
home	AACWQ
exact	AACWR
hemispherical	AACWS
magnetic	AACWT
levitation	AACWU
haptic	AACWV
device	AACWW
emergent	AACWX
approximability	AACWY
reconfigurable	AACWZ
locally	AACXA
excitatory	AACXB
globally	AACXC
inhibitory	AACXD
oscillator	AACXE
qr	AACXF
updating	AACXG
windowing	AACXH
inverting	AACXI
fixed	AACXJ
sized	AACXK
vectors	AACXL
enhances	AACXM
q	AACXN
predistorter	AACXO
dual	AACXP
loops	AACXQ
arrays	AACXR
norms	AACXS
interargument	AACXT
addressing	AACXU
partitioned	AACXV
integer	AACXW
unifying	AACXX
transformations	AACXY
telecommunications	AACXZ
deadlines	AACYA
prior	AACYB
completion	AACYC
category	AACYD
DistAl	AACYE
regularization	AACYF
contour	AACYG
snakes	AACYH
deformable	AACYI
contours	AACYJ
correspondences	AACYK
NESL	AACYL
hoare	AACYM
find	AACYN
median	AACYO
ada	AACYP
messy	AACYQ
subset	AACYR
comparing	AACYS
starts	AACYT
kreitz	AACYU
prefixes	AACYV
nonclassical	AACYW
expected	AACYX
length	AACYY
exit	AACYZ
maneuvers	AACZA
AHS	AACZB
RSA	AACZC
keys	AACZD
schedulability	AACZE
ap	AACZF
compiling	AACZG
schedu	AACZH
lable	AACZI
bisimulations	AACZJ
courtright	AACZK
ii	AACZL
transactional	AACZM
forward	AACZN
backward	AACZO
teams	AACZP
aditi	AACZQ
assembled	AACZR
behavioral	AACZS
VCO	AACZT
detectors	AACZU
lock	AACZV
multirate	AACZW
ptolemy	AACZX
nonparametric	AACZY
tsoi	AACZZ
back	AADAA
variance	AADAB
smoothness	AADAC
DSP	AADAD
isolation	AADAE
view	AADAF
experts	AADAG
exploring	AADAH
instance	AADAI
naive	AADAJ
attention	AADAK
decoupling	AADAL
asymptotic	AADAM
MIMO	AADAN
monte	AADAO
carlo	AADAP
futures	AADAQ
simplification	AADAR
quadric	AADAS
voxel	AADAT
levels	AADAU
oblivious	AADAV
energy	AADAW
driver	AADAX
adiabatic	AADAY
ai	AADAZ
treemaps	AADBA
visualize	AADBB
analytic	AADBC
hierarchy	AADBD
overviews	AADBE
inspiration	AADBF
CHI	AADBG
95	AADBH
ACE	AADBI
ObjectOriented	AADBJ
transforming	AADBK
ego	AADBL
autonomous	AADBM
cascaded	AADBN
nearly	AADBO
uncoupled	AADBP
chains	AADBQ
qos	AADBR
long	AADBS
dependent	AADBT
d	AADBU
channel	AADBV
establishment	AADBW
workloads	AADBX
malleable	AADBY
nonmalleable	AADBZ
uncalibrated	AADCA
recovery	AADCB
unknown	AADCC
epipolar	AADCD
stabilization	AADCE
byzantine	AADCF
agreement	AADCG
observations	AADCH
tolerating	AADCI
link	AADCJ
faults	AADCK
transient	AADCL
aperiodic	AADCM
requests	AADCN
preemptive	AADCO
TPS3	AADCP
facilities	AADCQ
programmers	AADCR
closing	AADCS
window	AADCT
vulnerability	AADCU
multiphase	AADCV
transactions	AADCW
nc	AADCX
comparability	AADCY
unique	AADCZ
perfect	AADDA
cubes	AADDB
covering	AADDC
superscalar	AADDD
boosting	AADDE
UNITY	AADDF
specific	AADDG
handlers	AADDH
messaging	AADDI
tipole	AADDJ
chromosomes	AADDK
testing	AADDL
demand	AADDM
DNF	AADDN
formulas	AADDO
membership	AADDP
slonim	AADDQ
monotone	AADDR
piecemeal	AADDS
exploration	AADDT
undirected	AADDU
team	AADDV
learn	AADDW
unlabeled	AADDX
diagrams	AADDY
fiber	AADDZ
dependency	AADEA
compilers	AADEB
transitivity	AADEC
accessibility	AADED
warmuth	AADEE
expert	AADEF
advice	AADEG
appearance	AADEH
aerial	AADEI
pac	AADEJ
tolerate	AADEK
algorithmica	AADEL
k	AADEM
incomplete	AADEN
behaviour	AADEO
x11	AADEP
workstation	AADEQ
specialization	AADER
digital	AADES
media	AADET
hypotheses	AADEU
underactuated	AADEV
eccentricity	AADEW
RING	AADEX
client	AADEY
joins	AADEZ
join	AADFA
indices	AADFB
psychophysical	AADFC
interpolation	AADFD
whole	AADFE
networked	AADFF
individualized	AADFG
courseware	AADFH
PDE	AADFI
defect	AADFJ
roles	AADFK
enact	AADFL
MVP	AADFM
s	AADFN
robocup	AADFO
challenge	AADFP
numeral	AADFQ
perturbation	AADFR
smooth	AADFS
entropy	AADFT
renyi	AADFU
linking	AADFV
reconciliation	AADFW
amplification	AADFX
reliabiity	AADFY
demonstration	AADFZ
foundations	AADGA
binding	AADGB
imperative	AADGC
gradient	AADGD
descent	AADGE
sun	AADGF
commercial	AADGG
RPC	AADGH
run	AADGI
diagnosing	AADGJ
bridging	AADGK
combinational	AADGL
stuck	AADGM
layer	AADGN
recurrent	AADGO
limitations	AADGP
formulae	AADGQ
backpropagation	AADGR
separates	AADGS
generalization	AADGT
retrospective	AADGU
integrate	AADGV
artificial	AADGW
intelligence	AADGX
steps	AADGY
principled	AADGZ
honavar	AADHA
linguistic	AADHB
phrase	AADHC
auctions	AADHD
gap	AADHE
organizing	AADHF
unsupervised	AADHG
toda	AADHH
secure	AADHI
compositions	AADHJ
core	AADHK
stateless	AADHL
queueing	AADHM
achieving	AADHN
approximately	AADHO
banwidth	AADHP
allocations	AADHQ
nteworks	AADHR
stores	AADHS
branches	AADHT
speculative	AADHU
GCV	AADHV
smoothing	AADHW
splines	AADHX
reliability	AADHY
UNIX	AADHZ
utilities	AADIA
investigating	AADIB
good	AADIC
ocean	AADID
ISDN	AADIE
special	AADIF
wired	AADIG
irradiance	AADIH
jacobian	AADII
occluded	AADIJ
representing	AADIK
laws	AADIL
grounding	AADIM
maruti	AADIN
SkyBlue	AADIO
ensemble	AADIP
postal	AADIQ
zip	AADIR
scanline	AADIS
implicitly	AADIT
defined	AADIU
sphylinders	AADIV
cone	AADIW
spheres	AADIX
rounded	AADIY
polygons	AADIZ
submitted	AADJA
graphics	AADJB
improvement	AADJC
UDP/IP	AADJD
DECstation	AADJE
5000	AADJF
gricean	AADJG
WordNet	AADJH
coherence	AADJI
evaluaiton	AADJJ
prepositional	AADJK
attachment	AADJL
abbreviated	AADJM
microscope	AADJN
tweezers	AADJO
virus	AADJP
november	AADJQ
1988	AADJR
identifying	AADJS
textual	AADJT
versions	AADJU
primitive	AADJV
anisotropic	AADJW
inviscid	AADJX
viscous	AADJY
trade	AADJZ
endogenous	AADKA
partner	AADKB
economic	AADKC
radio	AADKD
astronomy	AADKE
characterizing	AADKF
multiprocessor	AADKG
intensive	AADKH
gathering	AADKI
defining	AADKJ
sensitivity	AADKK
competition	AADKL
without	AADKM
broadcast	AADKN
cast	AADKO
DNA	AADKP
life	AADKQ
net	AADKR
projections	AADKS
document	AADKT
mapped	AADKU
spline	AADKV
ANOVA	AADKW
component	AADKX
wise	AADKY
confidence	AADKZ
workstations	AADLA
penalized	AADLB
likelihood	AADLC
continuation	AADLD
spacecraft	AADLE
prototype	AADLF
modules	AADLG
surveillance	AADLH
final	AADLI
anytime	AADLJ
LDL++	AADLK
observable	AADLL
sequentiality	AADLM
full	AADLN
geyer	AADLO
maximum	AADLP
emergencies	AADLQ
tragedy	AADLR
commons	AADLS
reversible	AADLT
sampler	AADLU
auxilliary	AADLV
suppressing	AADLW
walks	AADLX
ordered	AADLY
overrelaxation	AADLZ
convergence	AADMA
rates	AADMB
RoboCup	AADMC
cup	AADMD
initiative	AADME
ml	AADMF
undoing	AADMG
serialization	AADMH
correctness	AADMI
CSDP	AADMJ
LANs	AADMK
transparent	AADML
mobility	AADMM
measured	AADMN
LAN	AADMO
trip	AADMP
uniformities	AADMQ
introduced	AADMR
prevention	AADMS
critique	AADMT
empty	AADMU
promise	AADMV
quantum	AADMW
plus	AADMX
workflow	AADMY
reflectance	AADMZ
texture	AADNA
recovering	AADNB
radiance	AADNC
maps	AADND
photographs	AADNE
projective	AADNF
TRAINREC	AADNG
feedforward	AADNH
correctly	AADNI
light	AADNJ
field	AADNK
average	AADNL
payoff	AADNM
markovian	AADNN
TCEL	AADNO
termination	AADNP
arguments	AADNQ
constraining	AADNR
generalisation	AADNS
scene	AADNT
elements	AADNU
generic	AADNV
PIQ	AADNW
DBMS	AADNX
kernel	AADNY
andorra	AADNZ
floating	AADOA
lisp	AADOB
roget	AADOC
categories	AADOD
trained	AADOE
capability	AADOF
QPC	AADOG
algernon	AADOH
ATractable	AADOI
adapting	AADOJ
situated	AADOK
position	AADOL
extremal	AADOM
points	AADON
storage	AADOO
primarily	AADOP
ficus	AADOQ
guaranteeing	AADOR
calibrating	AADOS
intermediate	AADOT
dispatching	AADOU
adaptability	AADOV
automating	AADOW
DCE	AADOX
ensuring	AADOY
sparsely	AADOZ
connected	AADPA
segment	AADPB
vista	AADPC
hy	AADPD
regions	AADPE
affine	AADPF
invariant	AADPG
distances	AADPH
steering	AADPI
inverses	AADPJ
squares	AADPK
SIAM	AADPL
19	AADPM
committees	AADPN
categorization	AADPO
employing	AADPP
giving	AADPQ
sa	AADPR
petri	AADPS
VDM	AADPT
sl	AADPU
assignment	AADPV
evaluate	AADPW
accounting	AADPX
survival	AADPY
improves	AADPZ
lynx	AADQA
interoperability	AADQB
deterministic	AADQC
denotational	AADQD
starburst	AADQE
chip	AADQF
organizations	AADQG
number	AADQH
transistors	AADQI
recognizing	AADQJ
walking	AADQK
figures	AADQL
XYT	AADQM
MIT	AADQN
laboratory	AADQO
section	AADQP
mechanism	AADQQ
reordering	AADQR
references	AADQS
betweenness	AADQT
coupling	AADQU
nonpolyhedral	AADQV
relaxations	AADQW
bisection	AADQX
interior	AADQY
min	AADQZ
eigenvalue	AADRA
accurate	AADRB
maintenance	AADRC
warehousing	AADRD
decisions	AADRE
optimistic	AADRF
deltas	AADRG
www	AADRH
LRP	AADRI
treadmill	AADRJ
sickness	AADRK
statically	AADRL
vector	AADRM
tractable	AADRN
vocabulary	AADRO
rational	AADRP
debugging	AADRQ
standard	AADRR
connections	AADRS
basic	AADRT
folding	AADRU
opportunistic	AADRV
canonical	AADRW
viewpoint	AADRX
invariance	AADRY
gaussian	AADRZ
incrementally	AADSA
adding	AADSB
orders	AADSC
looking	AADSD
capacity	AADSE
vertex	AADSF
splitting	AADSG
dags	AADSH
lossy	AADSI
multiprocessing	AADSJ
flat	AADSK
minima	AADSL
early	AADSM
hyperacuity	AADSN
measure	AADSO
b	AADSP
easily	AADSQ
programminable	AADSR
peer	AADSS
concrete	AADST
coalgebra	AADSU
zf	AADSV
root	AADSW
investigation	AADSX
measurements	AADSY
MasPar	AADSZ
mp	AADTA
1216a	AADTB
bitonic	AADTC
re	AADTD
ectance	AADTE
numerical	AADTF
singularities	AADTG
factor	AADTH
smart	AADTI
reconstruction	AADTJ
wavelet	AADTK
progressive	AADTL
equation	AADTM
CustoMalloc	AADTN
synthesized	AADTO
allocators	AADTP
mediating	AADTQ
diverse	AADTR
formats	AADTS
promotion	AADTT
alias	AADTU
coordinator	AADTV
metareasoning	AADTW
referential	AADTX
bulk	AADTY
groups	AADTZ
PIM	AADUA
sm	AADUB
unrestricted	AADUC
electrical	AADUD
resistance	AADUE
bounding	AADUF
cover	AADUG
shape	AADUH
cm	AADUI
5	AADUJ
prospero	AADUK
anonymous	AADUL
onion	AADUM
interesting	AADUN
expectations	AADUO
multiplexer	AADUP
multiservice	AADUQ
separations	AADUR
irreversible	AADUS
cross	AADUT
lightweight	AADUU
marker	AADUV
encoding	AADUW
ideal	AADUX
denoising	AADUY
orthonormal	AADUZ
compt	AADVA
primal	AADVB
bandwidth	AADVC
VBR	AADVD
correct	AADVE
MAC	AADVF
cable	AADVG
modem	AADVH
portfolio	AADVI
matchmaking	AADVJ
brokering	AADVK
utilization	AADVL
ISO	AADVM
lessons	AADVN
persistence	AADVO
fortran	AADVP
purpose	AADVQ
competitive	AADVR
OnLine	AADVS
tricia	AADVT
observability	AADVU
aspects	AADVV
dealing	AADVW
controllability	AADVX
probabilities	AADVY
proceeding	AADVZ
summer	AADWA
school	AADWB
animating	AADWC
athletics	AADWD
dimensions	AADWE
proving	AADWF
esoteric	AADWG
diversion	AADWH
industrial	AADWI
knows	AADWJ
uc	AADWK
multicomputers	AADWL
analogical	AADWM
scout	AADWN
repositories	AADWO
checkers	AADWP
upper	AADWQ
analyze	AADWR
GAFOs	AADWS
LMS	AADWT
principal	AADWU
settings	AADWV
probabiliteis	AADWW
default	AADWX
consul	AADWY
third	AADWZ
irregularly	AADXA
unimodular	AADXB
pl	AADXC
determinant	AADXD
RAIRO	AADXE
theoretical	AADXF
highway	AADXG
alternating	AADXH
lineality	AADXI
removal	AADXJ
copositive	AADXK
normal	AADXL
HTTP	AADXM
working	AADXN
ranking	AADXO
http	AADXP
beveridge	AADXQ
riseman	AADXR
optical	AADXS
distortion	AADXT
head	AADXU
mounted	AADXV
disp	AADXW
lays	AADXX
tr	AADXY
93	AADXZ
045	AADYA
terrain	AADYB
oblique	AADYC
jump	AADYD
implementations	AADYE
offs	AADYF
repetitive	AADYG
remarks	AADYH
ITL	AADYI
tempura	AADYJ
compositional	AADYK
dense	AADYL
responsive	AADYM
invariants	AADYN
referral	AADYO
dino	AADYP
predicates	AADYQ
actualized	AADYR
utility	AADYS
emergence	AADYT
classical	AADYU
relaxing	AADYV
SIMD	AADYW
perceive	AADYX
possibilities	AADYY
spatio	AADYZ
tolerates	AADZA
partitions	AADZB
host	AADZC
exercises	AADZD
definitions	AADZE
equivalence	AADZF
speedup	AADZG
hypothetical	AADZH
PAC	AADZI
inducing	AADZJ
parsers	AADZK
treebanks	AADZL
quest	AADZM
EGRET	AADZN
supported	AADZO
thematic	AADZP
scientific	AADZQ
objective	AADZR
vertically	AADZS
DDH	AADZT
reductions	AADZU
hartmanis	AADZV
conjecture	AADZW
truth	AADZX
table	AADZY
cluster	AADZZ
mixtures	AAEAA
stacked	AAEAB
density	AAEAC
APIC	AAEAD
DMA	AAEAE
other	AAEAF
definite	AAEAG
godel	AAEAH
restricted	AAEAI
quantification	AAEAJ
copying	AAEAK
locking	AAEAL
latching	AAEAM
resident	AAEAN
frequent	AAEAO
episodes	AAEAP
iteration	AAEAQ
characterizations	AAEAR
determinantal	AAEAS
determinants	AAEAT
old	AAEAU
tricks	AAEAV
dogs	AAEAW
ethology	AAEAX
creatures	AAEAY
cryptographically	AAEAZ
undeniable	AAEBA
unconditionally	AAEBB
signer	AAEBC
sender	AAEBD
unbounded	AAEBE
cremers	AAEBF
collision	AAEBG
avoidance	AAEBH
multimodal	AAEBI
augmented	AAEBJ
pragmatic	AAEBK
tech	AAEBL
multithreading	AAEBM
multiresolution	AAEBN
curves	AAEBO
advertisements	AAEBP
organizational	AAEBQ
CSP	AAEBR
presented	AAEBS
DIMACS	AAEBT
analyses	AAEBU
yahalom	AAEBV
IFAC	AAEBW
advanced	AAEBX
secretary	AAEBY
coevolution	AAEBZ
acute	AAECA
deep	AAECB
venous	AAECC
thrombosis	AAECD
elementary	AAECE
skills	AAECF
skill	AAECG
extensible	AAECH
sensorimotor	AAECI
sembly	AAECJ
iv	AAECK
MESH	AAECL
towsley	AAECM
scalabale	AAECN
telecommunication	AAECO
validating	AAECP
centering	AAECQ
updates	AAECR
base	AAECS
conformance	AAECT
securely	AAECU
breaking	AAECV
untraceable	AAECW
secret	AAECX
ballot	AAECY
election	AAECZ
radial	AAEDA
financial	AAEDB
novel	AAEDC
vytopil	AAEDD
PREENS	AAEDE
treewidth	AAEDF
stabbing	AAEDG
shooting	AAEDH
organic	AAEDI
NLU	AAEDJ
metric	AAEDK
touchscreen	AAEDL
keyboards	AAEDM
cartesian	AAEDN
polygon	AAEDO
attributive	AAEDP
fourier	AAEDQ
fit	AAEDR
lunch	AAEDS
theorems	AAEDT
goursat	AAEDU
forms	AAEDV
nonholo	AAEDW
nomic	AAEDX
gross	AAEDY
lemma	AAEDZ
calls	AAEEA
subregion	AAEEB
having	AAEEC
dominant	AAEED
peak	AAEEE
o	AAEEF
feasible	AAEEG
ting	AAEEH
scatter	AAEEI
ary	AAEEJ
multidestination	AAEEK
directory	AAEEL
medium	AAEEM
shallow	AAEEN
annotated	AAEEO
corpus	AAEEP
sign	AAEEQ
lyapunov	AAEER
1998	AAEES
property	AAEET
benefits	AAEEU
proc	AAEEV
inferring	AAEEW
DEC	AAEEX
alpha	AAEEY
commutative	AAEEZ
taming	AAEFA
y	AAEFB
crossover	AAEFC
larch	AAEFD
option	AAEFE
pricing	AAEFF
vortex	AAEFG
ligands	AAEFH
arrange	AAEFI
ments	AAEFJ
snap	AAEFK
rounding	AAEFL
editors	AAEFM
applied	AAEFN
SADL	AAEFO
cycles	AAEFP
considered	AAEFQ
harmful	AAEFR
composition	AAEFS
weighted	AAEFT
langue	AAEFU
slices	AAEFV
homotopic	AAEFW
deformation	AAEFX
influence	AAEFY
delays	AAEFZ
subtransitive	AAEGA
speeding	AAEGB
plausibility	AAEGC
RELATUS	AAEGD
lipreading	AAEGE
HOL	AAEGF
wave	AAEGG
heart	AAEGH
anew	AAEGI
augmenting	AAEGJ
branching	AAEGK
existential	AAEGL
atomic	AAEGM
propositions	AAEGN
executing	AAEGO
reprocessing	AAEGP
characterisation	AAEGQ
combination	AAEGR
almost	AAEGS
experimenting	AAEGT
cheeseman	AAEGU
stutz	AAEGV
evidence	AAEGW
biconnectivity	AAEGX
ten	AAEGY
lectures	AAEGZ
recall	AAEHA
bicon	AAEHB
nected	AAEHC
raw	AAEHD
benchmark	AAEHE
suite	AAEHF
reflective	AAEHG
ORB	AAEHH
trivial	AAEHI
collecting	AAEHJ
canon	AAEHK
score	AAEHL
inheritance	AAEHM
relation	AAEHN
treatment	AAEHO
uncertainties	AAEHP
utilizing	AAEHQ
past	AAEHR
degree	AAEHS
eigenlips	AAEHT
reformulation	AAEHU
appropriate	AAEHV
mapmaking	AAEHW
ability	AAEHX
formalisation	AAEHY
jungle	AAEHZ
uniqueness	AAEIA
efficent	AAEIB
nonstationary	AAEIC
sinusoids	AAEID
bibliography	AAEIE
timeslice	AAEIF
NREVERSAL	AAEIG
fortune	AAEIH
pp	AAEII
hyperbolic	AAEIJ
reclamation	AAEIK
lifetime	AAEIL
charge	AAEIM
asymptotically	AAEIN
haskell	AAEIO
feed	AAEIP
fairly	AAEIQ
sorts	AAEIR
shu*e	AAEIS
exchange	AAEIT
hypercubic	AAEIU
logarithmic	AAEIV
shellsort	AAEIW
weighting	AAEIX
five	AAEIY
balltree	AAEIZ
difference	AAEJA
ECG	AAEJB
contextual	AAEJC
clues	AAEJD
controls	AAEJE
trajectory	AAEJF
trailer	AAEJG
chained	AAEJH
threatening	AAEJI
BolotOn	AAEJJ
dependance	AAEJK
smallest	AAEJL
augmentation	AAEJM
biconnect	AAEJN
triconnectivity	AAEJO
preemption	AAEJP
multilevel	AAEJQ
randomized	AAEJR
mergesort	AAEJS
disks	AAEJT
sort	AAEJU
deployable	AAEJV
DPGA	AAEJW
creating	AAEJX
superclasses	AAEJY
substructure	AAEJZ
subdue	AAEKA
CLP	AAEKB
crystal	AAEKC
expression	AAEKD
toolset	AAEKE
identical	AAEKF
counter	AAEKG
deadlocks	AAEKH
party	AAEKI
beneffits	AAEKJ
VSS	AAEKK
track	AAEKL
multiparty	AAEKM
performatives	AAEKN
rationally	AAEKO
90	AAEKP
interacting	AAEKQ
parallelization	AAEKR
resolving	AAEKS
conflict	AAEKT
ma	AAEKU
chines	AAEKV
ASTRAL	AAEKW
intralevel	AAEKX
obligations	AAEKY
mercury	AAEKZ
multiscale	AAELA
double	AAELB
polyhedron	AAELC
pronunciation	AAELD
CMU	AAELE
1996	AAELF
hub	AAELG
flux	AAELH
multivalued	AAELI
annealed	AAELJ
multipoint	AAELK
ARQ	AAELL
destination	AAELM
bottleneck	AAELN
come	AAELO
go	AAELP
paper	AAELQ
symposium	AAELR
VLSI	AAELS
book	AAELT
generator	AAELU
encoder	AAELV
quantizer	AAELW
quantization	AAELX
intensional	AAELY
exponentially	AAELZ
filters	AAEMA
analytical	AAEMB
advantages	AAEMC
spectrum	AAEMD
analyzer	AAEME
sliding	AAEMF
DFT	AAEMG
foundational	AAEMH
methodological	AAEMI
difficult	AAEMJ
musical	AAEMK
rhythm	AAEML
test	AAEMM
incorporation	AAEMN
learining	AAEMO
specializing	AAEMP
rana	AAEMQ
nonlinearity	AAEMR
hyperplane	AAEMS
behavioural	AAEMT
repertoire	AAEMU
SAP	AAEMV
announcement	AAEMW
retrieving	AAEMX
behave	AAEMY
socially	AAEMZ
region	AAENA
reducible	AAENB
cauchy	AAENC
preconditioners	AAEND
turn	AAENE
travel	AAENF
uninterpreted	AAENG
apparatus	AAENH
ThreadsEfficient	AAENI
lenient	AAENJ
speci	AAENK
fication	AAENL
hypercubes	AAENM
lesser	AAENN
fa	AAENO
man	AAENP
options	AAENQ
iPSC	AAENR
860	AAENS
node	AAENT
genus	AAENU
checkpoints	AAENV
kanazawa	AAENW
live	AAENX
cas	AAENY
lwww	AAENZ
mechanical	AAEOA
assemblies	AAEOB
TRAINS	AAEOC
91	AAEOD
dialogues	AAEOE
god	AAEOF
display	AAEOG
correcting	AAEOH
repairs	AAEOI
applying	AAEOJ
develop	AAEOK
middleware	AAEOL
forwarding	AAEOM
lookups	AAEON
probabalistic	AAEOO
hostile	AAEOP
structur	AAEOQ
XOR	AAEOR
erasure	AAEOS
resilient	AAEOT
gemmell	AAEOU
FEC	AAEOV
solve	AAEOW
midnight	AAEOX
madness	AAEOY
closest	AAEOZ
01	AAEPA
conscious	AAEPB
rep	AAEPC
resentation	AAEPD
deformations	AAEPE
multifrontal	AAEPF
clique	AAEPG
taxation	AAEPH
moment	AAEPI
hypergeometric	AAEPJ
precision	AAEPK
focus	AAEPL
dead	AAEPM
extraposition	AAEPN
union	AAEPO
private	AAEPP
bootstrapping	AAEPQ
cscw	AAEPR
sumedh	AAEPS
mungee	AAEPT
TAO	AAEPU
facial	AAEPV
reason	AAEPW
monotonic	AAEPX
american	AAEPY
faces	AAEPZ
acoustic	AAEQA
nonhuman	AAEQB
noises	AAEQC
spontaneous	AAEQD
janus	AAEQE
SEER	AAEQF
rendered	AAEQG
approximations	AAEQH
couplings	AAEQI
speculatively	AAEQJ
history	AAEQK
microarchitecture	AAEQL
proces	AAEQM
sors	AAEQN
polychotomous	AAEQO
browser	AAEQP
graceful	AAEQQ
guaranteed	AAEQR
encodings	AAEQS
isabelle	AAEQT
prover	AAEQU
obligation	AAEQV
FME97	AAEQW
chaos	AAEQX
routers	AAEQY
uniform	AAEQZ
sensorless	AAERA
parts	AAERB
orienting	AAERC
joint	AAERD
ParaScope	AAERE
editor	AAERF
probing	AAERG
nonprehensile	AAERH
multiplexing	AAERI
rudin	AAERJ
williamson	AAERK
pen	AAERL
ink	AAERM
illustration	AAERN
symbol	AAERO
discovers	AAERP
regular	AAERQ
grammar	AAERR
dfa	AAERS
NCSA	AAERT
manipulate	AAERU
steiner	AAERV
ratio	AAERW
precompiler	AAERX
selecrion	AAERY
valid	AAERZ
TSP	AAESA
math	AAESB
reservation	AAESC
quick	AAESD
changes	AAESE
trac	AAESF
statistics	AAESG
MST	AAESH
all	AAESI
nearest	AAESJ
neighbors	AAESK
subsymbolic	AAESL
sentences	AAESM
clauses	AAESN
ising	AAESO
determination	AAESP
spelled	AAESQ
letter	AAESR
recognizer	AAESS
within	AAEST
forecasting	AAESU
ellipsis	AAESV
sojourn	AAESW
customers	AAESX
batch	AAESY
identities	AAESZ
mean	AAETA
squared	AAETB
alternatives	AAETC
gang	AAETD
objectives	AAETE
converging	AAETF
approximated	AAETG
fairness	AAETH
kernelized	AAETI
mantis	AAETJ
factoring	AAETK
polynomials	AAETL
fewer	AAETM
bits	AAETN
variability	AAETO
distillation	AAETP
collaboratories	AAETQ
dissemination	AAETR
successive	AAETS
broadcasts	AAETT
hypercube	AAETU
routed	AAETV
multiport	AAETW
adaptivity	AAETX
h	AAETY
preprint	AAETZ
disturbances	AAEUA
programmable	AAEUB
utile	AAEUC
9	AAEUD
gram	AAEUE
fat	AAEUF
shattering	AAEUG
fur	AAEUH
needed	AAEUI
sauer	AAEUJ
RSIM	AAEUK
highly	AAEUL
dilation	AAEUM
embedding	AAEUN
junctions	AAEUO
correspondence	AAEUP
streamlining	AAEUQ
controller	AAEUR
quickhull	AAEUS
hulls	AAEUT
md	AAEUU
argumentation	AAEUV
converting	AAEUW
credit	AAEUX
documentation	AAEUY
reconstructing	AAEUZ
advisory	AAEVA
intentional	AAEVB
rhetorical	AAEVC
checked	AAEVD
initializing	AAEVE
othello	AAEVF
singly	AAEVG
datasets	AAEVH
interpersonal	AAEVI
reject	AAEVJ
fusion	AAEVK
tissue	AAEVL
mr	AAEVM
compositionality	AAEVN
SLD	AAEVO
derivations	AAEVP
moore	AAEVQ
completions	AAEVR
interpretations	AAEVS
formant	AAEVT
paragraph	AAEVU
expository	AAEVV
PROLOG	AAEVW
st	AAEVX
bpp	AAEVY
subexponential	AAEVZ
unless	AAEWA
exptime	AAEWB
publishable	AAEWC
accompanist	AAEWD
music	AAEWE
cognitive	AAEWF
pc++	AAEWG
simon	AAEWH
cellular	AAEWI
soundness	AAEWJ
ex	AAEWK
pressibility	AAEWL
growth	AAEWM
MAX	AAEWN
np	AAEWO
made	AAEWP
samplers	AAEWQ
limit	AAEWR
acts	AAEWS
ground	AAEWT
conversation	AAEWU
preferential	AAEWV
prisoner	AAEWW
dilemma	AAEWX
mixing	AAEWY
multicom	AAEWZ
modity	AAEXA
combinatorics	AAEXB
asymmetric	AAEXC
encryption	AAEXD
logarithms	AAEXE
ISU	AAEXF
39	AAEXG
dot	AAEXH
iterated	AAEXI
refusal	AAEXJ
partners	AAEXK
sp	AAEXL
removing	AAEXM
randomness	AAEXN
penalty	AAEXO
correlated	AAEXP
expressivity	AAEXQ
UCPOP	AAEXR
graphplan	AAEXS
prototypical	AAEXT
symmetric	AAEXU
alternation	AAEXV
captures	AAEXW
BPP	AAEXX
ambiguity	AAEXY
motions	AAEXZ
multiframe	AAEYA
analyzers	AAEYB
tagging	AAEYC
compaction	AAEYD
organising	AAEYE
stratified	AAEYF
chess	AAEYG
policy	AAEYH
RPSL	AAEYI
ietf	AAEYJ
rps	AAEYK
rpsl	AAEYL
00	AAEYM
para	AAEYN
scope	AAEYO
goals	AAEYP
arbitrary	AAEYQ
ancient	AAEYR
lexicalized	AAEYS
subcategorization	AAEYT
frames	AAEYU
entries	AAEYV
interlingual	AAEYW
mt	AAEYX
americas	AAEYY
partnerships	AAEYZ
lexicons	AAEZA
states	AAEZB
TCP	AAEZC
sublinear	AAEZD
undi	AAEZE
rected	AAEZF
shading	AAEZG
beats	AAEZH
15	AAEZI
traverse	AAEZJ
edges	AAEZK
moving	AAEZL
closer	AAEZM
DDM	AAEZN
guidance	AAEZO
10	AAEZP
topologies	AAEZQ
make	AAEZR
passwords	AAEZS
harder	AAEZT
crack	AAEZU
cardiology	AAEZV
cardiovascular	AAEZW
activation	AAEZX
kanerva	AAEZY
SDM	AAEZZ
comments	AAFAA
stored	AAFAB
rationalistic	AAFAC
ecological	AAFAD
labeling	AAFAE
drawings	AAFAF
scenes	AAFAG
resection	AAFAH
collinearity	AAFAI
ceiling	AAFAJ
tracker	AAFAK
implement	AAFAL
represented	AAFAM
advisor	AAFAN
sheet	AAFAO
metal	AAFAP
fabrication	AAFAQ
IIE	AAFAR
enforcement	AAFAS
blaze	AAFAT
encrypting	AAFAU
multivariate	AAFAV
HighSpeed	AAFAW
native	AAFAX
stack	AAFAY
fuzzy	AAFAZ
timeseries	AAFBA
notification	AAFBB
characterize	AAFBC
projects	AAFBD
discipline	AAFBE
xunet	AAFBF
handoff	AAFBG
maintenace	AAFBH
tempo	AAFBI
OPT	AAFBJ
SQL	AAFBK
ds	AAFBL
actor	AAFBM
business	AAFBN
reengineering	AAFBO
erlang	AAFBP
hessenberg	AAFBQ
monitors	AAFBR
exible	AAFBS
merging	AAFBT
receptive	AAFBU
histograms	AAFBV
tycho	AAFBW
incompleteness	AAFBX
inclusions	AAFBY
tioning	AAFBZ
banks	AAFCA
foralls	AAFCB
concise	AAFCC
realistic	AAFCD
struction	AAFCE
television	AAFCF
archives	AAFCG
barriers	AAFCH
mono	AAFCI
runge	AAFCJ
kutta	AAFCK
BDIM	AAFCL
ANew	AAFCM
adaptively	AAFCN
NAS	AAFCO
LATEX	AAFCP
satisficing	AAFCQ
criteria	AAFCR
cis	AAFCS
et	AAFCT
al	AAFCU
disco	AAFCV
VLIW	AAFCW
stall	AAFCX
CLONES	AAFCY
layerd	AAFCZ
NEtwork	AAFDA
faster	AAFDB
linkage	AAFDC
grammatical	AAFDD
papers	AAFDE
heads	AAFDF
complexes	AAFDG
HPC	AAFDH
skeletons	AAFDI
innovative	AAFDJ
systematic	AAFDK
period	AAFDL
queues	AAFDM
PVM	AAFDN
DARPA	AAFDO
spoken	AAFDP
definable	AAFDQ
brief	AAFDR
cryptoanalysis	AAFDS
bidirectional	AAFDT
exist	AAFDU
dissipation	AAFDV
particle	AAFDW
interference	AAFDX
jobs	AAFDY
surely	AAFDZ
singular	AAFEA
doubly	AAFEB
smaller	AAFEC
switch	AAFED
drop	AAFEE
worms	AAFEF
cut	AAFEG
100000	AAFEH
restoring	AAFEI
accents	AAFEJ
spanish	AAFEK
french	AAFEL
lifestreams	AAFEM
elastic	AAFEN
sublogarithmic	AAFEO
whitrow	AAFEP
cursive	AAFEQ
script	AAFER
debruijn	AAFES
external	AAFET
handwriting	AAFEU
drawing	AAFEV
interconnection	AAFEW
chou	AAFEX
fasman	AAFEY
expressed	AAFEZ
giles	AAFFA
collingwood	AAFFB
banded	AAFFC
GAs	AAFFD
semantically	AAFFE
lumped	AAFFF
configurator	AAFFG
deamons	AAFFH
commit	AAFFI
gigabit	AAFFJ
yes	AAFFK
vote	AAFFL
MITL	AAFFM
unreliable	AAFFN
transverse	AAFFO
asymmetry	AAFFP
crossed	AAFFQ
diode	AAFFR
ripple	AAFFS
96	AAFFT
9th	AAFFU
sept	AAFFV
foundation	AAFFW
decomposing	AAFFX
attempt	AAFFY
empirically	AAFFZ
teach	AAFGA
fall	AAFGB
harvest	AAFGC
monadic	AAFGD
SNP	AAFGE
minimality	AAFGF
decomposability	AAFGG
row	AAFGH
multipath	AAFGI
MECA	AAFGJ
broadcasting	AAFGK
ring	AAFGL
injured	AAFGM
target	AAFGN
inconsistency	AAFGO
DRESUN	AAFGP
boost	AAFGQ
multiclass	AAFGR
rated	AAFGS
predictions	AAFGT
tuning	AAFGU
definability	AAFGV
various	AAFGW
mediated	AAFGX
forthcoming	AAFGY
componential	AAFGZ
kinship	AAFHA
proposed	AAFHB
pre	AAFHC
CDV	AAFHD
fairisle	AAFHE
RACE	AAFHF
EXPLOIT	AAFHG
multidatabase	AAFHH
jitter	AAFHI
mal	AAFHJ
spectral	AAFHK
norm	AAFHL
irreducible	AAFHM
algorihm	AAFHN
cycle	AAFHO
tasking	AAFHP
beliefs	AAFHQ
intentions	AAFHR
amalgamated	AAFHS
acting	AAFHT
SNePS	AAFHU
modechart	AAFHV
workstaions	AAFHW
BAN	AAFHX
LOTOS	AAFHY
decoupled	AAFHZ
exception	AAFIA
PDP	AAFIB
relative	AAFIC
translucent	AAFID
escrow	AAFIE
fractional	AAFIF
escrowed	AAFIG
distributional	AAFIH
phonotactic	AAFII
diagnostics	AAFIJ
comparative	AAFIK
tempered	AAFIL
read	AAFIM
null	AAFIN
numa	AAFIO
force	AAFIP
inexact	AAFIQ
ucla	AAFIR
circulation	AAFIS
chemical	AAFIT
tracer	AAFIU
bottlenecks	AAFIV
EOSDIS	AAFIW
morphology	AAFIX
greedy	AAFIY
satisfiability	AAFIZ
reformulations	AAFJA
nn	AAFJB
realtime	AAFJC
hoover	AAFJD
engineer	AAFJE
introductory	AAFJF
course	AAFJG
wallace	AAFJH
perturbance	AAFJI
feasibility	AAFJJ
exokernel	AAFJK
backtracking	AAFJL
ng	AAFJM
backmarking	AAFJN
AIP	AAFJO
rollbacks	AAFJP
temporary	AAFJQ
CAPITL	AAFJR
tn	AAFJS
reckoning	AAFJT
lunar	AAFJU
rover	AAFJV
eye	AAFJW
strain	AAFJX
stereoscopic	AAFJY
hemodynamic	AAFJZ
ICU	AAFKA
patients	AAFKB
compiled	AAFKC
reflecting	AAFKD
ocr	AAFKE
independency	AAFKF
RMI	AAFKG
HPC++	AAFKH
supernodal	AAFKI
pivoting	AAFKJ
grabbing	AAFKK
manipulating	AAFKL
immersive	AAFKM
handed	AAFKN
workbench	AAFKO
bimanual	AAFKP
proprioception	AAFKQ
poly	AAFKR
ln	AAFKS
develops	AAFKT
BackPropagation	AAFKU
collective	AAFKV
approxmation	AAFKW
disjoint	AAFKX
diameter	AAFKY
mostly	AAFKZ
viable	AAFLA
mark	AAFLB
sweep	AAFLC
strength	AAFLD
flaw	AAFLE
woven	AAFLF
textiles	AAFLG
clutter	AAFLH
modu	AAFLI
larizing	AAFLJ
codescriptive	AAFLK
hints	AAFLL
lambert	AAFLM
w	AAFLN
triangles	AAFLO
357	AAFLP
363	AAFLQ
deciding	AAFLR
observation	AAFLS
lags	AAFLT
perceived	AAFLU
SCROOGE	AAFLV
perceptually	AAFLW
acuity	AAFLX
lag	AAFLY
teleoperators	AAFLZ
decoding	AAFMA
reed	AAFMB
solomon	AAFMC
areas	AAFMD
symmetry	AAFME
suffix	AAFMF
batching	AAFMG
VCR	AAFMH
movie	AAFMI
notes	AAFMJ
OMOS	AAFMK
mathematical	AAFML
redesign	AAFMM
missing	AAFMN
abduction	AAFMO
relaxed	AAFMP
granularity	AAFMQ
dsm	AAFMR
loosely	AAFMS
euler	AAFMT
replicating	AAFMU
internetworks	AAFMV
invariances	AAFMW
locating	AAFMX
anycasting	AAFMY
subgraphs	AAFMZ
tiagent	AAFNA
CMUnited	AAFNB
97	AAFNC
concave	AAFND
backwards	AAFNE
temporally	AAFNF
predictability	AAFNG
store	AAFNH
latencies	AAFNI
original	AAFNJ
revised	AAFNK
videodisk	AAFNL
appropriateness	AAFNM
widget	AAFNN
layouts	AAFNO
actively	AAFNP
subprograms	AAFNQ
bookshelf	AAFNR
repository	AAFNS
SEI	AAFNT
supercomputers	AAFNU
tenses	AAFNV
verbs	AAFNW
scalability	AAFNX
computes	AAFNY
prefix	AAFNZ
uysal	AAFOA
CHAOS	AAFOB
procs	AAFOC
interrogative	AAFOD
formalizations	AAFOE
ethernet	AAFOF
myths	AAFOG
divide	AAFOH
conquer	AAFOI
hiding	AAFOJ
indpendent	AAFOK
modified	AAFOL
HME	AAFOM
naturally	AAFON
illuminated	AAFOO
nuprl	AAFOP
terms	AAFOQ
interposition	AAFOR
randomly	AAFOS
sampled	AAFOT
multivari	AAFOU
ate	AAFOV
ohne	AAFOW
suche	AAFOX
aeromedical	AAFOY
evacuation	AAFOZ
ontologies	AAFPA
tempest	AAFPB
davis	AAFPC
putnam	AAFPD
weakest	AAFPE
precondition	AAFPF
recursion	AAFPG
generalist	AAFPH
specialist	AAFPI
due	AAFPJ
individual	AAFPK
extracting	AAFPL
abilities	AAFPM
horizon	AAFPN
schedule	AAFPO
datagram	AAFPP
gateways	AAFPQ
necessary	AAFPR
condition	AAFPS
translates	AAFPT
compactly	AAFPU
confluence	AAFPV
indexed	AAFPW
rochester	AAFPX
noun	AAFPY
adjective	AAFPZ
meanings	AAFQA
account	AAFQB
multistage	AAFQC
further	AAFQD
facts	AAFQE
changing	AAFQF
supply	AAFQG
stable	AAFQH
playback	AAFQI
restart	AAFQJ
parcel	AAFQK
actuator	AAFQL
vehicle	AAFQM
recycling	AAFQN
pcps	AAFQO
linearity	AAFQP
imperfect	AAFQQ
desire	AAFQR
speaking	AAFQS
dialog	AAFQT
conversational	AAFQU
rescoring	AAFQV
evening	AAFQW
berferd	AAFQX
cracker	AAFQY
lured	AAFQZ
DCE++	AAFRA
OSF	AAFRB
predicated	AAFRC
spilling	AAFRD
retargetable	AAFRE
gateway	AAFRF
abstractin	AAFRG
illinois	AAFRH
concert	AAFRI
street	AAFRJ
cancer	AAFRK
prognosis	AAFRL
breast	AAFRM
cytology	AAFRN
acceptance	AAFRO
possibility	AAFRP
ph	AAFRQ
ming	AAFRR
con	AAFRS
tinuous	AAFRT
john	AAFRU
wiley	AAFRV
sons	AAFRW
HPF	AAFRX
remappings	AAFRY
IMTAS	AAFRZ
EDA	AAFSA
classificatin	AAFSB
encounter	AAFSC
record	AAFSD
indexes	AAFSE
silhouette	AAFSF
screen	AAFSG
lighting	AAFSH
subtraction	AAFSI
scripts	AAFSJ
story	AAFSK
scaleable	AAFSL
superhighway	AAFSM
write	AAFSN
barrier	AAFSO
flight	AAFSP
aware	AAFSQ
mental	AAFSR
generalizations	AAFSS
heavy	AAFST
tailed	AAFSU
major	AAFSV
college	AAFSW
basketball	AAFSX
generators	AAFSY
coin	AAFSZ
tossing	AAFTA
SSCOP	AAFTB
gaede	AAFTC
quadtrees	AAFTD
hausdorff	AAFTE
fractal	AAFTF
neighbor	AAFTG
navigational	AAFTH
builder	AAFTI
2q	AAFTJ
ted	AAFTK
constructor	AAFTL
automatically	AAFTM
orderings	AAFTN
labelling	AAFTO
passive	AAFTP
place	AAFTQ
select	AAFTR
landmarks	AAFTS
occupancy	AAFTT
shift	AAFTU
integral	AAFTV
operators	AAFTW
lp	AAFTX
DLP	AAFTY
experiment	AAFTZ
par	AAFUA
allelizing	AAFUB
rewrite	AAFUC
garland	AAFUD
visible	AAFUE
eyes	AAFUF
have	AAFUG
taxonomy	AAFUH
visualizations	AAFUI
7	AAFUJ
RHODOS	AAFUK
multispectral	AAFUL
histogram	AAFUM
investigations	AAFUN
roy	AAFUO
every	AAFUP
cylindrical	AAFUQ
utilising	AAFUR
prosodic	AAFUS
divergent	AAFUT
step	AAFUU
bee	AAFUV
stanford	AAFUW
name	AAFUX
hillclimbing	AAFUY
metropolitan	AAFUZ
pyramid	AAFVA
higraph	AAFVB
globe	AAFVC
geons	AAFVD
operational	AAFVE
formalization	AAFVF
incentive	AAFVG
contracting	AAFVH
subspace	AAFVI
recognizers	AAFVJ
expan	AAFVK
sion	AAFVL
SMART	AAFVM
logp	AAFVN
staircases	AAFVO
culler	AAFVP
NOW	AAFVQ
now	AAFVR
topical	AAFVS
trusted	AAFVT
inhibition	AAFVU
synaptic	AAFVV
cells	AAFVW
operability	AAFVX
zurek	AAFVY
per	AAFVZ
remark	AAFWA
controllable	AAFWB
artstein	AAFWC
orem	AAFWD
partitionable	AAFWE
subjectivity	AAFWF
genvoca	AAFWG
verifiably	AAFWH
triggered	AAFWI
ontology	AAFWJ
capabilities	AAFWK
triangular	AAFWL
prescheduled	AAFWM
DAGs	AAFWN
nondegeneracy	AAFWO
SDPpack	AAFWP
beta	AAFWQ
phrasal	AAFWR
spider	AAFWS
RFC	AAFWT
2009	AAFWU
bringing	AAFWV
morphing	AAFWW
phd	AAFWX
dissertation	AAFWY
lifting	AAFWZ
threading	AAFXA
dsms	AAFXB
309	AAFXC
enforcing	AAFXD
titanium	AAFXE
OBJ3	AAFXF
imperfectly	AAFXG
nested	AAFXH
router	AAFXI
express	AAFXJ
participating	AAFXK
instructional	AAFXL
explanations	AAFXM
cooperating	AAFXN
EPOS	AAFXO
diterpene	AAFXP
elucidation	AAFXQ
13c	AAFXR
NMR	AAFXS
spectra	AAFXT
invalidation	AAFXU
reduc	AAFXV
EXPECT	AAFXW
normalized	AAFXX
met	AAFXY
rics	AAFXZ
need	AAFYA
only	AAFYB
disjunction	AAFYC
ac	AAFYD
specializations	AAFYE
silhouettes	AAFYF
resemblance	AAFYG
representative	AAFYH
curved	AAFYI
literature	AAFYJ
networs	AAFYK
build	AAFYL
classifers	AAFYM
hardness	AAFYN
rea	AAFYO
soning	AAFYP
goldin	AAFYQ
algebras	AAFYR
journal	AAFYS
dbms	AAFYT
tight	AAFYU
OODB	AAFYV
coroutines	AAFYW
77	AAFYX
avoiding	AAFYY
overfitting	AAFYZ
bp	AAFZA
SOM	AAFZB
XCS	AAFZC
most	AAFZD
container	AAFZE
shipping	AAFZF
xi	AAFZG
freezing	AAFZH
words	AAFZI
rod	AAFZJ
counterfactual	AAFZK
counterfactuals	AAFZL
localized	AAFZM
identifiability	AAFZN
henrion	AAFZO
contributions	AAFZP
dependences	AAFZQ
sensitivities	AAFZR
shanks	AAFZS
intercausal	AAFZT
hetrogeneous	AAFZU
pentium	AAFZV
bug	AAFZW
betweem	AAFZX
nomials	AAFZY
introdution	AAFZZ
searches	AAGAA
kaleidoscope93	AAGAB
neurocon	AAGAC
trollers	AAGAD
designed	AAGAE
wandering	AAGAF
miniaturization	AAGAG
newton	AAGAH
assuring	AAGAI
runlength	AAGAJ
quantized	AAGAK
DCT	AAGAL
coefficients	AAGAM
recurrences	AAGAN
suitable	AAGAO
meets	AAGAP
TDLA	AAGAQ
protecting	AAGAR
poorly	AAGAS
secrets	AAGAT
guessing	AAGAU
attacks	AAGAV
effectiveness	AAGAW
rectilinear	AAGAX
pathwidth	AAGAY
geometrical	AAGAZ
spanners	AAGBA
banyans	AAGBB
ridge	AAGBC
reproducing	AAGBD
hilbert	AAGBE
GACV	AAGBF
lmc	AAGBG
DIPART	AAGBH
adaptor	AAGBI
portability	AAGBJ
encapsulation	AAGBK
MICE	AAGBL
langle	AAGBM
th	AAGBN
jukebox	AAGBO
sessions	AAGBP
timer	AAGBQ
reconsideration	AAGBR
RTP	AAGBS
RTSP	AAGBT
seven	AAGBU
safety	AAGBV
ESTEREL	AAGBW
rus	AAGBX
SMP	AAGBY
committee	AAGBZ
admissibility	AAGCA
fixpoint	AAGCB
pushing	AAGCC
envelope	AAGCD
propositional	AAGCE
entity	AAGCF
provably	AAGCG
convergent	AAGCH
multilayer	AAGCI
perceptron	AAGCJ
holonomic	AAGCK
handoffs	AAGCL
coscheduling	AAGCM
assigning	AAGCN
multiprogrammed	AAGCO
smoothed	AAGCP
cepstral	AAGCQ
VIS	AAGCR
CEDER	AAGCS
restarting	AAGCT
coexistence	AAGCU
achieve	AAGCV
functionality	AAGCW
weakness	AAGCX
envelopes	AAGCY
monitored	AAGCZ
intrusive	AAGDA
affects	AAGDB
placing	AAGDC
seek	AAGDD
complementing	AAGDE
mRNA	AAGDF
donor	AAGDG
acceptor	AAGDH
sites	AAGDI
SpeechActs	AAGDJ
engine	AAGDK
enquiry	AAGDL
built	AAGDM
forming	AAGDN
diderot	AAGDO
MUC	AAGDP
versioning	AAGDQ
everywhere	AAGDR
nondeterministic	AAGDS
fully	AAGDT
subtypes	AAGDU
faulttolerant	AAGDV
promises	AAGDW
batched	AAGDX
lifelong	AAGDY
inferential	AAGDZ
vol	AAGEA
nodes	AAGEB
metacognitive	AAGEC
regulating	AAGED
4x4	AAGEE
losses	AAGEF
overload	AAGEG
CAD	AAGEH
strategic	AAGEI
negotiations	AAGEJ
reforming	AAGEK
toolkits	AAGEL
printing	AAGEM
2nd	AAGEN
organized	AAGEO
typologically	AAGEP
calculations	AAGEQ
tensorial	AAGER
gt	AAGES
lens	AAGET
brightness	AAGEU
assumptions	AAGEV
mixins	AAGEW
scoping	AAGEX
bindings	AAGEY
scopes	AAGEZ
keeping	AAGFA
minimizing	AAGFB
weights	AAGFC
deflectors	AAGFD
priori	AAGFE
playing	AAGFF
liveness	AAGFG
aided	AAGFH
1510	AAGFI
deficiencies	AAGFJ
mocha	AAGFK
congested	AAGFL
shamir	AAGFM
snir	AAGFN
character	AAGFO
orientation	AAGFP
discontinuity	AAGFQ
illusory	AAGFR
cluttered	AAGFS
backgrounds	AAGFT
noncommutative	AAGFU
laser	AAGFV
micromachined	AAGFW
mirror	AAGFX
microvibromotor	AAGFY
cloud	AAGFZ
LogicsFormal	AAGGA
reps	AAGGB
answer	AAGGC
nonmonotonic	AAGGD
servoing	AAGGE
coupled	AAGGF
hands	AAGGG
misalignment	AAGGH
criterion	AAGGI
registers	AAGGJ
nontrivial	AAGGK
hypercuboid	AAGGL
gorithms	AAGGM
compound	AAGGN
encountered	AAGGO
SPELL	AAGGP
reform	AAGGQ
KSR	AAGGR
parents	AAGGS
experiencing	AAGGT
passage	AAGGU
EREW	AAGGV
CREW	AAGGW
PRAMs	AAGGX
sub	AAGGY
bus	AAGGZ
trainable	AAGHA
summarizer	AAGHB
untagged	AAGHC
wonder	AAGHD
years	AAGHE
MATLAB	AAGHF
h1	AAGHG
structuring	AAGHH
summarisation	AAGHI
widgets	AAGHJ
ladder	AAGHK
hand	AAGHL
thesis	AAGHM
extra	AAGHN
PROMOTER	AAGHO
nicolson	AAGHP
fearing	AAGHQ
mating	AAGHR
fastener	AAGHS
writing	AAGHT
drivers	AAGHU
spatially	AAGHV
blur	AAGHW
g	AAGHX
nagy	AAGHY
OLeary	AAGHZ
completable	AAGIA
significant	AAGIB
diffie	AAGIC
hellman	AAGID
public	AAGIE
cryptosystem	AAGIF
ciphertext	AAGIG
buzz	AAGIH
instantiation	AAGII
rc	AAGIJ
intractibility	AAGIK
thor	AAGIL
think	AAGIM
decentralizing	AAGIN
methodologies	AAGIO
OPS5	AAGIP
replicability	AAGIQ
diagram	AAGIR
acceleration	AAGIS
forest	AAGIT
establishing	AAGIU
refinements	AAGIV
certificates	AAGIW
nectivity	AAGIX
XTP	AAGIY
technologies	AAGIZ
known	AAGJA
RSVP	AAGJB
iinvestigation	AAGJC
maximizing	AAGJD
striped	AAGJE
replaceability	AAGJF
NSF	AAGJG
benchmarking	AAGJH
FIFO	AAGJI
spin	AAGJJ
locks	AAGJK
swap	AAGJL
abstracting	AAGJM
tower	AAGJN
hanoi	AAGJO
manipulable	AAGJP
pay	AAGJQ
reallocation	AAGJR
vineet	AAGJS
buch	AAGJT
boltzmann	AAGJU
BIBLIOGRAPHY	AAGJV
stiff	AAGJW
rk	AAGJX
nonintrusive	AAGJY
weyl	AAGJZ
heisenberg	AAGKA
riesz	AAGKB
l	AAGKC
enhance	AAGKD
serial	AAGKE
CACM	AAGKF
sunspots	AAGKG
multigrid	AAGKH
explore	AAGKI
emphasis	AAGKJ
categorical	AAGKK
jet	AAGKL
pipe	AAGKM
electropneu	AAGKN
matic	AAGKO
spatialization	AAGKP
inexpensive	AAGKQ
mercator	AAGKR
nonvisual	AAGKS
x	AAGKT
resiliency	AAGKU
robustness	AAGKV
adjoint	AAGKW
arising	AAGKX
brayton	AAGKY
XBD0	AAGKZ
multiplicative	AAGLA
schwarz	AAGLB
nonsymmetric	AAGLC
indefinite	AAGLD
angular	AAGLE
velocity	AAGLF
endpoint	AAGLG
total	AAGLH
crackdowns	AAGLI
illicit	AAGLJ
drug	AAGLK
markets	AAGLL
traversals	AAGLM
satanic	AAGLN
notations	AAGLO
definitional	AAGLP
adventures	AAGLQ
DSMC	AAGLR
plate	AAGLS
restructuring	AAGLT
animation	AAGLU
differentiated	AAGLV
hosting	AAGLW
van	AAGLX
der	AAGLY
minimisation	AAGLZ
factory	AAGMA
reward	AAGMB
fourteenth	AAGMC
shop	AAGMD
com	AAGME
putation	AAGMF
realizability	AAGMG
transformational	AAGMH
setup	AAGMI
machined	AAGMJ
holding	AAGMK
corrective	AAGML
whiteboard	AAGMM
navigable	AAGMN
nonlinearly	AAGMO
separable	AAGMP
madaline	AAGMQ
conjunctions	AAGMR
fan	AAGMS
resistant	AAGMT
password	AAGMU
sided	AAGMV
deployment	AAGMW
compositing	AAGMX
telerobotic	AAGMY
meet	AAGMZ
bisimulation	AAGNA
coalgebraic	AAGNB
troubleshoot	AAGNC
gesture	AAGND
geoscientific	AAGNE
fitting	AAGNF
GLOW	AAGNG
kilo	AAGNH
sci	AAGNI
wisconsin	AAGNJ
wind	AAGNK
tunnel	AAGNL
commentary	AAGNM
OSDI	AAGNN
1st	AAGNO
mls	AAGNP
CFD	AAGNQ
textured	AAGNR
pose	AAGNS
ilp	AAGNT
genearl	AAGNU
leve	AAGNV
disaster	AAGNW
surviving	AAGNX
misbehaving	AAGNY
cornell	AAGNZ
topics	AAGOA
compensation	AAGOB
min/max	AAGOC
SDSI	AAGOD
euclidean	AAGOE
medians	AAGOF
segmented	AAGOG
MRI	AAGOH
strikes	AAGOI
facility	AAGOJ
violation	AAGOK
planners	AAGOL
mentat	AAGOM
factorizations	AAGON
minimax	AAGOO
rollback	AAGOP
reformulating	AAGOQ
slye	AAGOR
interrupts	AAGOS
perceptive	AAGOT
entertainment	AAGOU
untethered	AAGOV
audition	AAGOW
grobner	AAGOX
explicitly	AAGOY
coevolving	AAGOZ
BDD	AAGPA
package	AAGPB
documenting	AAGPC
eases	AAGPD
downward	AAGPE
collapse	AAGPF
certificate	AAGPG
illustrated	AAGPH
defense	AAGPI
carrier	AAGPJ
DIMSEMs	AAGPK
diagonally	AAGPL
interpolating	AAGPM
vanishing	AAGPN
ODE	AAGPO
interprocess	AAGPP
salient	AAGPQ
candidate	AAGPR
pools	AAGPS
conflicts	AAGPT
repair	AAGPU
rabaey	AAGPV
possible	AAGPW
flipping	AAGPX
ran	AAGPY
domized	AAGPZ
witnesses	AAGQA
sequencing	AAGQB
provers	AAGQC
genome	AAGQD
directories	AAGQE
proceedingsof	AAGQF
94	AAGQG
health	AAGQH
validity	AAGQI
ends	AAGQJ
feeders	AAGQK
vibrations	AAGQL
consolidation	AAGQM
coronary	AAGQN
artery	AAGQO
disease	AAGQP
amoeba	AAGQQ
crust	AAGQR
fi	AAGQS
skeleton	AAGQT
curve	AAGQU
voronoi	AAGQV
extentron	AAGQW
displays	AAGQX
picard	AAGQY
learns	AAGQZ
LikeIt	AAGRA
supercomputing	AAGRB
agenda	AAGRC
serving	AAGRD
toleranced	AAGRE
landmark	AAGRF
FiniteState	AAGRG
contingency	AAGRH
krawczyk	AAGRI
psuedorandom	AAGRJ
cascade	AAGRK
assist	AAGRL
hypergeo	AAGRM
watercolor	AAGRN
signing	AAGRO
DSS	AAGRP
lie	AAGRQ
brackets	AAGRR
analyticity	AAGRS
juggler	AAGRT
feeding	AAGRU
MAcs	AAGRV
pseudorandom	AAGRW
modulation	AAGRX
annealing	AAGRY
scientist	AAGRZ
universe	AAGSA
everything	AAGSB
given	AAGSC
trapdoor	AAGSD
permutation	AAGSE
subsurface	AAGSF
contaminant	AAGSG
biodegradation	AAGSH
kinetics	AAGSI
logically	AAGSJ
rectangular	AAGSK
groundwater	AAGSL
timings	AAGSM
rabin	AAGSN
f	AAGSO
ormal	AAGSP
erification	AAGSQ
ault	AAGSR
prolegomena	AAGSS
declaratively	AAGST
specified	AAGSU
MPEG	AAGSV
PET	AAGSW
irrelevance	AAGSX
splice	AAGSY
translational	AAGSZ
start	AAGTA
eukaryotic	AAGTB
continuations	AAGTC
SOR	AAGTD
waveform	AAGTE
clusters	AAGTF
assimilating	AAGTG
legacy	AAGTH
enhancing	AAGTI
insensitive	AAGTJ
unions	AAGTK
multigauge	AAGTL
unconditional	AAGTM
htn	AAGTN
MaPS	AAGTO
VRML	AAGTP
ranked	AAGTQ
ant	AAGTR
colony	AAGTS
traveling	AAGTT
salesman	AAGTU
autocatalytic	AAGTV
manuscript	AAGTW
available	AAGTX
006	AAGTY
ensembles	AAGTZ
bagging	AAGUA
randomization	AAGUB
cli	AAGUC
ent	AAGUD
maintain	AAGUE
authenticated	AAGUF
deviation	AAGUG
baskets	AAGUH
correlations	AAGUI
tospeed	AAGUJ
languageacquisitions	AAGUK
unmanned	AAGUL
paradyn	AAGUM
dextrous	AAGUN
manipulations	AAGUO
rapidly	AAGUP
ball	AAGUQ
occluding	AAGUR
unfamiliar	AAGUS
distraction	AAGUT
phonetic	AAGUU
mechanizing	AAGUV
opportunities	AAGUW
challenges	AAGUX
yield	AAGUY
plane	AAGUZ
playground	AAGVA
associations	AAGVB
alternate	AAGVC
kit	AAGVD
tension	AAGVE
literalism	AAGVF
anaphora	AAGVG
exemplars	AAGVH
retrieve	AAGVI
optima	AAGVJ
lattices	AAGVK
EXTENT	AAGVL
mneme	AAGVM
simpler	AAGVN
honest	AAGVO
verifier	AAGVP
dishonest	AAGVQ
CTRS90	AAGVR
montreal	AAGVS
canada	AAGVT
12	AAGVU
kalman	AAGVV
auer	AAGVW
resonance	AAGVX
meter	AAGVY
indeterminacy	AAGVZ
ramifications	AAGWA
selectional	AAGWB
HIPED	AAGWC
ping	AAGWD
pong	AAGWE
sudden	AAGWF
giant	AAGWG
asparagos96	AAGWH
seagate	AAGWI
elite	AAGWJ
COLING	AAGWK
92	AAGWL
cohesion	AAGWM
quantify	AAGWN
restructure	AAGWO
enabled	AAGWP
VLDB	AAGWQ
better	AAGWR
inlining	AAGWS
gapping	AAGWT
implicature	AAGWU
safeware	AAGWV
concerning	AAGWW
GMR	AAGWX
lecture	AAGWY
email	AAGWZ
babel	AAGXA
MIXes	AAGXB
argument	AAGXC
favor	AAGXD
presumed	AAGXE
create	AAGXF
unicode	AAGXG
MIME	AAGXH
separate	AAGXI
construct	AAGXJ
NPSI	AAGXK
PDES	AAGXL
substitutional	AAGXM
definiteness	AAGXN
japa	AAGXO
nese	AAGXP
backoff	AAGXQ
equals	AAGXR
borel	AAGXS
cantelli	AAGXT
stochasticity	AAGXU
significantly	AAGXV
paying	AAGXW
creative	AAGXX
sentence	AAGXY
CIRCA	AAGXZ
cassini	AAGYA
saturn	AAGYB
orbit	AAGYC
prepositioning	AAGYD
NASA	AAGYE
intended	AAGYF
proactive	AAGYG
RAID	AAGYH
writes	AAGYI
essential	AAGYJ
DMPPs	AAGYK
percolating	AAGYL
selector	AAGYM
negamaxing	AAGYN
provable	AAGYO
consequences	AAGYP
coping	AAGYQ
MAGIC	AAGYR
briefings	AAGYS
post	AAGYT
bypass	AAGYU
explicitness	AAGYV
anaphoric	AAGYW
blind	AAGYX
combines	AAGYY
assignments	AAGYZ
sys	AAGZA
tem	AAGZB
identifiers	AAGZC
spoofing	AAGZD
POOMA	AAGZE
groupware	AAGZF
coprocessor	AAGZG
nerve	AAGZH
spiking	AAGZI
axons	AAGZJ
pronouncing	AAGZK
names	AAGZL
ANAPRON	AAGZM
malik	AAGZN
eduard	AAGZO
hovy	AAGZP
SCS	AAGZQ
fasteners	AAGZR
micro	AAGZS
rig	AAGZT
dataset	AAGZU
turing	AAGZV
equivalent	AAGZW
zooming	AAGZX
starfield	AAGZY
KASTOR	AAGZZ
motorized	AAHAA
zoom	AAHAB
lenses	AAHAC
prof	AAHAD
casasent	AAHAE
XIII	AAHAF
inspection	AAHAG
PRAM	AAHAH
ERCW	AAHAI
monocular	AAHAJ
lips	AAHAK
column	AAHAL
stride	AAHAM
proportional	AAHAN
share	AAHAO
mangement	AAHAP
inaccessible	AAHAQ
stackable	AAHAR
filing	AAHAS
prob	AAHAT
lems	AAHAU
crypto	AAHAV
89	AAHAW
optimised	AAHAX
fragments	AAHAY
luby	AAHAZ
rackoff	AAHBA
characteristic	AAHBB
routines	AAHBC
SPMD	AAHBD
sums	AAHBE
wires	AAHBF
overcoming	AAHBG
pin	AAHBH
FPGA	AAHBI
emulators	AAHBJ
vuurpijl	AAHBK
schouten	AAHBL
bilinear	AAHBM
flexibility	AAHBN
unity	AAHBO
eike	AAHBP
informativeness	AAHBQ
promoter	AAHBR
obtaining	AAHBS
cryptosystems	AAHBT
DIN	AAHBU
hyperlink	AAHBV
shotgun	AAHBW
SPACE	AAHBX
causation	AAHBY
gradients	AAHBZ
generate	AAHCA
chaining	AAHCB
MARVEL	AAHCC
CCL	AAHCD
tunable	AAHCE
MPI	AAHCF
delayed	AAHCG
rewards	AAHCH
zahorjan	AAHCI
paging	AAHCJ
nullstellensatz	AAHCK
h20	AAHCL
separation	AAHCM
prewhitening	AAHCN
maximisation	AAHCO
mpeg	AAHCP
transmissions	AAHCQ
optimizers	AAHCR
continually	AAHCS
running	AAHCT
indoor	AAHCU
interleaving	AAHCV
physically	AAHCW
nonrigid	AAHCX
IFIP	AAHCY
inserted	AAHCZ
give	AAHDA
take	AAHDB
balanced	AAHDC
ment	AAHDD
timesensitive	AAHDE
TSQL2	AAHDF
inexpressible	AAHDG
unconstrained	AAHDH
pointers	AAHDI
fuzz	AAHDJ
dijkstra	AAHDK
triangle	AAHDL
triangulator	AAHDM
MIMD	AAHDN
BLAS	AAHDO
mappings	AAHDP
boresight	AAHDQ
aligned	AAHDR
PLAPACK	AAHDS
PRISM	AAHDT
35	AAHDU
LPAR	AAHDV
ametek	AAHDW
2010	AAHDX
fox	AAHDY
PARTI	AAHDZ
chemistry	AAHEA
aerodynamics	AAHEB
egocentric	AAHEC
multisensor	AAHED
mantaras	AAHEE
discretization	AAHEF
beehive	AAHEG
primer	AAHEH
BRL	AAHEI
strange	AAHEJ
posteriori	AAHEK
degeneracy	AAHEL
reparameterization	AAHEM
reassignment	AAHEN
antenna	AAHEO
newsgroup	AAHEP
websom	AAHEQ
eliminating	AAHER
hook	AAHES
WCNN96	AAHET
reflectors	AAHEU
animated	AAHEV
surrogate	AAHEW
helicopter	AAHEX
lexicon	AAHEY
backgammon	AAHEZ
player	AAHFA
categorizing	AAHFB
grounded	AAHFC
vitro	AAHFD
vivo	AAHFE
stage	AAHFF
modulo	AAHFG
optimum	AAHFH
interpreters	AAHFI
composing	AAHFJ
mon	AAHFK
ads	AAHFL
mirage	AAHFM
SQP	AAHFN
frictional	AAHFO
walls	AAHFP
PDS	AAHFQ
either	AAHFR
recogntion	AAHFS
minds	AAHFT
schubert	AAHFU
steamroller	AAHFV
hdl	AAHFW
mechanically	AAHFX
iozantine	AAHFY
floorplanning	AAHFZ
ICs	AAHGA
algo	AAHGB
rithm	AAHGC
boyer	AAHGD
199	AAHGE
hough	AAHGF
iue	AAHGG
useless	AAHGH
misses	AAHGI
tracing	AAHGJ
archaeology	AAHGK
yping	AAHGL
keyboard	AAHGM
renegotiable	AAHGN
proxies	AAHGO
solved	AAHGP
unsolved	AAHGQ
recognise	AAHGR
sylvester	AAHGS
bezout	AAHGT
resultant	AAHGU
DASH	AAHGV
ic	AAHGW
MOS	AAHGX
transistor	AAHGY
mismatch	AAHGZ
schemas	AAHHA
see	AAHHB
hear	AAHHC
inferencing	AAHHD
reasoner	AAHHE
minority	AAHHF
genetically	AAHHG
gated	AAHHH
regimes	AAHHI
subtopic	AAHHJ
analyzed	AAHHK
reprise	AAHHL
winners	AAHHM
metaphors	AAHHN
faceted	AAHHO
own	AAHHP
teaching	AAHHQ
disentangling	AAHHR
lost	AAHHS
terminology	AAHHT
DEF	AAHHU
USE	AAHHV
statements	AAHHW
DSM	AAHHX
involvement	AAHHY
learing	AAHHZ
stabilizing	AAHIA
leader	AAHIB
bodies	AAHIC
forces	AAHID
curvature	AAHIE
essences	AAHIF
gb	AAHIG
parser	AAHIH
GLR	AAHII
epsilon	AAHIJ
embodied	AAHIK
cognition	AAHIL
matrices	AAHIM
pursuit	AAHIN
origins	AAHIO
basing	AAHIP
sumption	AAHIQ
6	AAHIR
fl	AAHIS
inapproximability	AAHIT
admissions	AAHIU
pipeline	AAHIV
continuity	AAHIW
baldi	AAHIX
picco	AAHIY
Digital/Analog	AAHIZ
vectorizing	AAHJA
interleav	AAHJB
pressed	AAHJC
textures	AAHJD
excluded	AAHJE
minors	AAHJF
plotting	AAHJG
extrema	AAHJH
tail	AAHJI
REmote	AAHJJ
pager	AAHJK
interconnections	AAHJL
uniformity	AAHJM
epipoles	AAHJN
heading	AAHJO
direction	AAHJP
describing	AAHJQ
canonization	AAHJR
tensors	AAHJS
expressibility	AAHJT
perspectives	AAHJU
optimistically	AAHJV
CC++	AAHJW
notation	AAHJX
polyvariant	AAHJY
modification	AAHJZ
outdoor	AAHKA
staggered	AAHKB
SPIFFI	AAHKC
intel	AAHKD
paragon	AAHKE
ceteris	AAHKF
paribus	AAHKG
comparatives	AAHKH
assembling	AAHKI
tertiary	AAHKJ
residual	AAHKK
modelchecking	AAHKL
tape	AAHKM
synchronizing	AAHKN
categorize	AAHKO
peg	AAHKP
hole	AAHKQ
leverage	AAHKR
kramer	AAHKS
methodical	AAHKT
superconvergence	AAHKU
postprocessing	AAHKV
fluxes	AAHKW
lowest	AAHKX
tetrahedra	AAHKY
law	AAHKZ
succession	AAHLA
glossing	AAHLB
receding	AAHLC
subroutine	AAHLD
calculate	AAHLE
desired	AAHLF
KryptoKnight	AAHLG
museum	AAHLH
installations	AAHLI
ticomputer	AAHLJ
left	AAHLK
ventricular	AAHLL
wall	AAHLM
SPAMM	AAHLN
cognizant	AAHLO
six	AAHLP
deadline	AAHLQ
accord	AAHLR
neu	AAHLS
ral	AAHLT
arithmetization	AAHLU
BTA	AAHLV
cfl	AAHLW
PerkinsNetwork	AAHLX
metaphoric	AAHLY
metabank	AAHLZ
conventions	AAHMA
CPU	AAHMB
metadata	AAHMC
satellite	AAHMD
contract	AAHME
hydrophobic	AAHMF
polar	AAHMG
races	AAHMH
acoustics	AAHMI
scattering	AAHMJ
element	AAHMK
diversity	AAHML
focal	AAHMM
themes	AAHMN
freshness	AAHMO
replay	AAHMP
spacetime	AAHMQ
collaborating	AAHMR
referring	AAHMS
academic	AAHMT
firewall	AAHMU
SURF	AAHMV
boosters	AAHMW
interconnects	AAHMX
warping	AAHMY
rasmussen	AAHMZ
touch	AAHNA
MD5	AAHNB
SLDNF	AAHNC
migrating	AAHND
terminals	AAHNE
syntax	AAHNF
pretty	AAHNG
multidimen	AAHNH
sional	AAHNI
subtyping	AAHNJ
FLINT	AAHNK
javatecode	AAHNL
subroutines	AAHNM
exportable	AAHNN
SIS	AAHNO
neurocontrol	AAHNP
chapter	AAHNQ
fertility	AAHNR
weather	AAHNS
details	AAHNT
EMERALD	AAHNU
reports	AAHNV
MLI	AAHNW
INLEN	AAHNX
totally	AAHNY
implemenation	AAHNZ
nx	AAHOA
SHRIMP	AAHOB
transportable	AAHOC
worm	AAHOD
interconnect	AAHOE
rounds	AAHOF
fool	AAHOG
gold	AAHOH
proxess	AAHOI
architec	AAHOJ
tures	AAHOK
choosing	AAHOL
forcing	AAHOM
fixtures	AAHON
modula	AAHOO
2*	AAHOP
PIOUS	AAHOQ
stop	AAHOR
copy	AAHOS
count	AAHOT
charlotte	AAHOU
DECs	AAHOV
tation	AAHOW
learner	AAHOX
parallelized	AAHOY
MVA	AAHOZ
vienna	AAHPA
condensed	AAHPB
hazard	AAHPC
underwater	AAHPD
mammals	AAHPE
bcm	AAHPF
butterfly	AAHPG
multiplexed	AAHPH
multibutterfly	AAHPI
short	AAHPJ
haul	AAHPK
junction	AAHPL
optimize	AAHPM
CDMA	AAHPN
imprecise	AAHPO
ode	AAHPP
comprehending	AAHPQ
orthogonal	AAHPR
distinct	AAHPS
bar	AAHPT
titolerant	AAHPU
repetitivezantine	AAHPV
easier	AAHPW
LIfelong	AAHPX
axiomatizing	AAHPY
weakly	AAHPZ
stabilty	AAHQA
spec	AAHQB
ification	AAHQC
metamorphic	AAHQD
literal	AAHQE
superdatabases	AAHQF
summary	AAHQG
tsimmis	AAHQH
CISC	AAHQI
similar	AAHQJ
neurocontrollers	AAHQK
classifications	AAHQL
hinted	AAHQM
ActorSpace	AAHQN
separators	AAHQO
negative	AAHQP
portions	AAHQQ
precedents	AAHQR
refreshment	AAHQS
warehouse	AAHQT
swizzling	AAHQU
huge	AAHQV
return	AAHQW
rejection	AAHQX
rowles	AAHQY
peripherals	AAHQZ
subgoals	AAHRA
friend	AAHRB
hub4	AAHRC
steepest	AAHRD
pheom	AAHRE
ena	AAHRF
motivate	AAHRG
cue	AAHRH
frontier	AAHRI
big	AAHRJ
subfigure	AAHRK
RCSP	AAHRL
goa	AAHRM
conserving	AAHRN
disciplines	AAHRO
breadth	AAHRP
puzzle	AAHRQ
pliant	AAHRR
adaption	AAHRS
emulation	AAHRT
asynchrony	AAHRU
itera	AAHRV
tors	AAHRW
aggregate	AAHRX
uniprocessor	AAHRY
breeding	AAHRZ
grasping	AAHSA
dagstuhl	AAHSB
steam	AAHSC
boiler	AAHSD
sketches	AAHSE
ecursive	AAHSF
hitting	AAHSG
rectangles	AAHSH
salishan	AAHSI
boxology	AAHSJ
styles	AAHSK
reciprocity	AAHSL
teacher	AAHSM
supplied	AAHSN
samples	AAHSO
wearable	AAHSP
wearcam	AAHSQ
constants	AAHSR
khintchine	AAHSS
CASE	AAHST
naming	AAHSU
announcements	AAHSV
unbiased	AAHSW
SCI	AAHSX
SAFER	AAHSY
preparation	AAHSZ
intra	AAHTA
sadri	AAHTB
subramanian	AAHTC
CollusionSecure	AAHTD
fingerprinting	AAHTE
memories	AAHTF
strate	AAHTG
gies	AAHTH
internetwork	AAHTI
chorus	AAHTJ
ADAPTIVE	AAHTK
ADIC	AAHTL
REMAP	AAHTM
adaptations	AAHTN
tuition	AAHTO
manchester	AAHTP
formulations	AAHTQ
coulomb	AAHTR
friction	AAHTS
projection	AAHTT
BCM	AAHTU
cortical	AAHTV
plasticity	AAHTW
extensive	AAHTX
cruise	AAHTY
versatile	AAHTZ
substitution	AAHUA
axiom	AAHUB
gravity	AAHUC
fails	AAHUD
judgements	AAHUE
multiversion	AAHUF
bad	AAHUG
society	AAHUH
mind	AAHUI
laissez	AAHUJ
faire	AAHUK
economy	AAHUL
idiots	AAHUM
agoric	AAHUN
portraits	AAHUO
wm	AAHUP
surpassing	AAHUQ
TLB	AAHUR
su	AAHUS
perpages	AAHUT
sizes	AAHUU
superpage	AAHUV
AVIARY	AAHUW
imagistic	AAHUX
loads	AAHUY
enabling	AAHUZ
observe	AAHVA
react	AAHVB
har	AAHVC
nessing	AAHVD
terminological	AAHVE
vague	AAHVF
saw	AAHVG
want	AAHVH
seed	AAHVI
explain	AAHVJ
dill	AAHVK
manintegration	AAHVL
does	AAHVM
majority	AAHVN
votes	AAHVO
centralized	AAHVP
survivability	AAHVQ
inserts	AAHVR
deletes	AAHVS
half	AAHVT
FPGAs	AAHVU
occam	AAHVV
razors	AAHVW
sharp	AAHVX
blunt	AAHVY
exercise	AAHVZ
tailored	AAHWA
PCPs	AAHWB
nasa	AAHWC
obstacle	AAHWD
OORAM	AAHWE
axioms	AAHWF
DVSM	AAHWG
meshix	AAHWH
essence	AAHWI
visitor	AAHWJ
quantifications	AAHWK
extract	AAHWL
revise	AAHWM
loading	AAHWN
setting	AAHWO
cpu	AAHWP
benefitting	AAHWQ
faulty	AAHWR
oracles	AAHWS
juggling	AAHWT
push	AAHWU
kernels	AAHWV
FilesystemsGuaranteeing	AAHWW
MachIn	AAHWX
SymposiumDecember1997	AAHWY
MITRE	AAHWZ
downwards	AAHXA
PFffi	AAHXB
enumeration	AAHXC
1993	AAHXD
sport	AAHXE
injuries	AAHXF
stages	AAHXG
dementia	AAHXH
proebsting	AAHXI
SGML	AAHXJ
standards	AAHXK
edit	AAHXL
overtraining	AAHXM
accepted	AAHXN
publication	AAHXO
WebGalaxy	AAHXP
adl	AAHXQ
handle	AAHXR
LUT	AAHXS
hoisting	AAHXT
super	AAHXU
HTML	AAHXV
formatting	AAHXW
aid	AAHXX
thorup	AAHXY
belew	AAHXZ
challenged	AAHYA
KQML	AAHYB
matchmaker	AAHYC
refine	AAHYD
truncating	AAHYE
td	AAHYF
perform	AAHYG
alarm	AAHYH
enjoy	AAHYI
shaping	AAHYJ
though	AAHYK
syntesis	AAHYL
mutually	AAHYM
predators	AAHYN
prey	AAHYO
explorations	AAHYP
laying	AAHYQ
taking	AAHYR
learners	AAHYS
vp	AAHYT
interpreting	AAHYU
cohesive	AAHYV
PCP	AAHYW
pandemonium	AAHYX
woodfield	AAHYY
pun	AAHYZ
NonLinear	AAHZA
PRoc	AAHZB
CVPR	AAHZC
781	AAHZD
785	AAHZE
BRACE	AAHZF
continuously	AAHZG
macro	AAHZH
cilk	AAHZI
replacing	AAHZJ
eligibility	AAHZK
scales	AAHZL
teamwork	AAHZM
kurose	AAHZN
worlds	AAHZO
voting	AAHZP
variants	AAHZQ
critic	AAHZR
cooperate	AAHZS
legged	AAHZT
shot	AAHZU
tar	AAHZV
get	AAHZW
parsimonious	AAHZX
bridges	AAHZY
desk	AAHZZ
expressiveness	AAIAA
AQUA	AAIAB
portfolios	AAIAC
helmbold	AAIAD
adder	AAIAE
powerlists	AAIAF
onto	AAIAG
sequent	AAIAH
calculi	AAIAI
79	AAIAJ
compatibility	AAIAK
64	AAIAL
indexicality	AAIAM
indexical	AAIAN
utterance	AAIAO
units	AAIAP
lightwave	AAIAQ
fortran90	AAIAR
opportunity	AAIAS
classrooms	AAIAT
friendly	AAIAU
JoJo	AAIAV
frog	AAIAW
bi	AAIAX
directional	AAIAY
acyclic	AAIAZ
lip	AAIBA
perimeter	AAIBB
trough	AAIBC
relays	AAIBD
equipment	AAIBE
corporation	AAIBF
retim	AAIBG
sublanguage	AAIBH
april	AAIBI
involving	AAIBJ
certain	AAIBK
cinematography	AAIBL
roadmap	AAIBM
jection	AAIBN
dependable	AAIBO
determinacy	AAIBP
fork	AAIBQ
blocking	AAIBR
latin	AAIBS
square	AAIBT
verify	AAIBU
runway	AAIBV
PA8000	AAIBW
stepping	AAIBX
serializability	AAIBY
photometric	AAIBZ
queuing	AAICA
deficit	AAICB
robin	AAICC
WUCS	AAICD
17	AAICE
acetabular	AAICF
implant	AAICG
speciation	AAICH
macros	AAICI
simliarity	AAICJ
queued	AAICK
steered	AAICL
beam	AAICM
transaural	AAICN
lab	AAICO
nonmasking	AAICP
faulttolerance	AAICQ
zebra	AAICR
trainer	AAICS
FLASH	AAICT
DBMiner	AAICU
spotting	AAICV
operant	AAICW
skinnerbots	AAICX
inclusion	AAICY
MDL	AAICZ
coverage	AAIDA
claims	AAIDB
trends	AAIDC
spots	AAIDD
ethological	AAIDE
hamsterdam	AAIDF
inverted	AAIDG
linkages	AAIDH
commonsense	AAIDI
POSTGRES	AAIDJ
psyche	AAIDK
expander	AAIDL
MultiLevel	AAIDM
rialto	AAIDN
WAM	AAIDO
AKL	AAIDP
forall	AAIDQ
OFMP	AAIDR
informed	AAIDS
attached	AAIDT
reversibility	AAIDU
relating	AAIDV
multifunctions	AAIDW
formers	AAIDX
hypervisor	AAIDY
ru	AAIDZ
notebook	AAIEA
NIST	AAIEB
norvell	AAIEC
paige	AAIED
visibility	AAIEE
walkthroughs	AAIEF
tagger	AAIEG
zoning	AAIEH
III	AAIEI
OCR	AAIEJ
recipient	AAIEK
untraceability	AAIEL
spite	AAIEM
dining	AAIEN
cryptographers	AAIEO
serviceability	AAIEP
eurocrypt	AAIEQ
learnable	AAIER
numesh	AAIES
softwre	AAIET
tailoring	AAIEU
bigrams	AAIEV
MultiProcessing	AAIEW
probably	AAIEX
privileged	AAIEY
constitutions	AAIEZ
rationality	AAIFA
ZPL	AAIFB
WYSIWYG	AAIFC
PNF	AAIFD
makers	AAIFE
hq	AAIFF
ultra	AAIFG
amsterdam	AAIFH
strip	AAIFI
communica	AAIFJ
tion	AAIFK
responses	AAIFL
inferotemporal	AAIFM
monkeys	AAIFN
explicitely	AAIFO
affinity	AAIFP
prevent	AAIFQ
transforms	AAIFR
redistributions	AAIFS
berkeley	AAIFT
liquid	AAIFU
11	AAIFV
factorisation	AAIFW
interested	AAIFX
reinterpretation	AAIFY
utterances	AAIFZ
smalltalk	AAIGA
HMEs	AAIGB
equal	AAIGC
rights	AAIGD
same	AAIGE
interpreted	AAIGF
palmtop	AAIGG
tactical	AAIGH
assistants	AAIGI
ACT	AAIGJ
CAS	AAIGK
si	AAIGL
inductors	AAIGM
transformers	AAIGN
commodity	AAIGO
distrib	AAIGP
uted	AAIGQ
oz	AAIGR
result	AAIGS
immobilizing	AAIGT
organisation	AAIGU
helly	AAIGV
8th	AAIGW
adaptiveness	AAIGX
additional	AAIGY
repeatable	AAIGZ
haar	AAIHA
dispersal	AAIHB
parasites	AAIHC
icon	AAIHD
blue	AAIHE
rush	AAIHF
scripting	AAIHG
plateaus	AAIHH
plateau	AAIHI
satisfi	AAIHJ
fundamentals	AAIHK
RTL	AAIHL
linsker	AAIHM
hebbian	AAIHN
dorigo	AAIHO
29	AAIHP
fodor	AAIHQ
CST	AAIHR
holographic	AAIHS
reduced	AAIHT
drawn	AAIHU
pictorial	AAIHV
trol	AAIHW
subtractive	AAIHX
ft	AAIHY
linda	AAIHZ
anais	AAIIA
13o	AAIIB
concerns	AAIIC
PGM	AAIID
march	AAIIE
1997	AAIIF
precedence	AAIIG
divergences	AAIIH
FONN	AAIII
enclosing	AAIIJ
parallelogram	AAIIK
MineSet	AAIIL
comprehensible	AAIIM
tutoring	AAIIN
DaimlerBenz	AAIIO
statlog	AAIIP
hippocampal	AAIIQ
children	AAIIR
FLUID	AAIIS
georgia	AAIIT
rectangle	AAIIU
reset	AAIIV
circuitry	AAIIW
tikhonov	AAIIX
ARP	AAIIY
equivalences	AAIIZ
failing	AAIJA
wold	AAIJB
reinitialization	AAIJC
homograph	AAIJD
optimally	AAIJE
DOACROSS	AAIJF
master	AAIJG
transcription	AAIJH
transferring	AAIJI
demonstrations	AAIJJ
phonology	AAIJK
expectation	AAIJL
maximization	AAIJM
discover	AAIJN
motifs	AAIJO
biopolymers	AAIJP
megaprior	AAIJQ
homology	AAIJR
ROC	AAIJS
motif	AAIJT
enumerating	AAIJU
evicted	AAIJV
gait	AAIJW
spatiotemporal	AAIJX
variation	AAIJY
abelian	AAIJZ
stabilizer	AAIKA
provability	AAIKB
saturation	AAIKC
nonlinearities	AAIKD
noye	AAIKE
shrinkage	AAIKF
tiresolution	AAIKG
dont	AAIKH
BIBOP	AAIKI
allocating	AAIKJ
fits	AAIKK
accommodate	AAIKL
labels	AAIKM
authorization	AAIKN
ser	AAIKO
vice	AAIKP
morphological	AAIKQ
7th	AAIKR
ACL	AAIKS
dyn	AAIKT
fo	AAIKU
EPIC	AAIKV
HyTech	AAIKW
quickly	AAIKX
ones	AAIKY
lorentz	AAIKZ
gas	AAILA
patches	AAILB
commutation	AAILC
torque	AAILD
motors	AAILE
witness	AAILF
collapses	AAILG
waiting	AAILH
carnival	AAILI
innerview	AAILJ
BSP	AAILK
niques	AAILL
hull	AAILM
negatives	AAILN
1/session	AAILO
rotating	AAILP
RCQ	AAILQ
jersey	AAILR
optically	AAILS
intercon	AAILT
wdm	AAILU
MML	AAILV
mask	AAILW
refinable	AAILX
HME/HMM	AAILY
polyphone	AAILZ
competing	AAIMA
PARADISE	AAIMB
multicommodity	AAIMC
multihop	AAIMD
spread	AAIME
command	AAIMF
GTW++	AAIMG
PNNI	AAIMH
PPFS	AAIMI
HFS	AAIMJ
NSFNET	AAIMK
georeferenced	AAIML
hyperdocuments	AAIMM
fisheye	AAIMN
ms	AAIMO
DOS	AAIMP
hollywood	AAIMQ
storyboards	AAIMR
ecology	AAIMS
echo	AAIMT
juno	AAIMU
agnostic	AAIMV
gambling	AAIMW
rigged	AAIMX
casino	AAIMY
adversarial	AAIMZ
armed	AAINA
bandit	AAINB
electric	AAINC
sinc	AAIND
convolution	AAINE
daemons	AAINF
multiplicity	AAING
erosion	AAINH
hierarchic	AAINI
competences	AAINJ
rectification	AAINK
lookup	AAINL
cares	AAINM
subsets	AAINN
news	AAINO
westermann	AAINP
computa	AAINQ
kikinis	AAINR
modes	AAINS
combinatory	AAINT
corrects	AAINU
distributors	AAINV
schizophrenic	AAINW
asyn	AAINX
chronous	AAINY
peephole	AAINZ
VIEWNET	AAIOA
catalytic	AAIOB
threats	AAIOC
wrapper	AAIOD
absence	AAIOE
instrumentation	AAIOF
alertness	AAIOG
usability	AAIOH
omorphisms	AAIOI
robosoccer	AAIOJ
clean	AAIOK
bare	AAIOL
bones	AAIOM
texturing	AAION
responsiveness	AAIOO
switchin	AAIOP
PSPACE	AAIOQ
debaters	AAIOR
NFS	AAIOS
decade	AAIOT
turmoil	AAIOU
polyvariance	AAIOV
IMPACT	AAIOW
maryland	AAIOX
semidefinite	AAIOY
58	AAIOZ
longest	AAIPA
unapproximable	AAIPB
io	AAIPC
ganymede	AAIPD
callisto	AAIPE
amultiagent	AAIPF
pegasus	AAIPG
multidatabases	AAIPH
signaling	AAIPI
counters	AAIPJ
bottum	AAIPK
indution	AAIPL
rich	AAIPM
conciseness	AAIPN
wildcard	AAIPO
syntactically	AAIPP
recognizable	AAIPQ
modularly	AAIPR
clausal	AAIPS
metaphor	AAIPT
could	AAIPU
routes	AAIPV
critter	AAIPW
SUIF	AAIPX
biologically	AAIPY
contradiction	AAIPZ
denoting	AAIQA
intersecting	AAIQB
subgroups	AAIQC
eu	AAIQD
clidean	AAIQE
topographic	AAIQF
linearly	AAIQG
projected	AAIQH
preconditioned	AAIQI
conjugate	AAIQJ
IDL	AAIQK
car	AAIQL
panoramic	AAIQM
mosaics	AAIQN
VideoBrush	AAIQO
isomorphism	AAIQP
holds	AAIQQ
compute	AAIQR
UMass	AAIQS
done	AAIQT
tridiagonal	AAIQU
guidelines	AAIQV
benjamins	AAIQW
postponement	AAIQX
idea	AAIQY
moments	AAIQZ
winnow	AAIRA
spelling	AAIRB
echolocation	AAIRC
phonological	AAIRD
accent	AAIRE
restoration	AAIRF
notions	AAIRG
normalisation	AAIRH
normalisations	AAIRI
standardisations	AAIRJ
SVIQUEL	AAIRK
LOCOCODE	AAIRL
cmu	AAIRM
cambridge	AAIRN
predict	AAIRO
coli	AAIRP
astronomical	AAIRQ
tandem	AAIRR
100	AAIRS
brute	AAIRT
walk	AAIRU
krakatoa	AAIRV
chronicle	AAIRW
newspaper	AAIRX
versioned	AAIRY
subtree	AAIRZ
meerkat	AAISA
soar	AAISB
implementors	AAISC
MIP	AAISD
reasoners	AAISE
ProtoDL	AAISF
subsumption	AAISG
CLASSIC	AAISH
STARTS	AAISI
purposive	AAISJ
NIKL	AAISK
parasitics	AAISL
reconstruc	AAISM
observer	AAISN
GMRES	AAISO
QMR	AAISP
BICG	AAISQ
ax	AAISR
mechanics	AAISS
nonequilibrium	AAIST
promising	AAISU
rescheduling	AAISV
baseline	AAISW
startburst	AAISX
estimators	AAISY
fingerprint	AAISZ
eads	AAITA
REtrieval	AAITB
UOWHFs	AAITC
securing	AAITD
applicability	AAITE
bootstrap	AAITF
SeReal	AAITG
EDO	AAITH
optimizer	AAITI
characters	AAITJ
prosody	AAITK
disfluency	AAITL
inheritances	AAITM
stepwise	AAITN
assertional	AAITO
works	AAITP
machining	AAITQ
mrsevs	AAITR
szepesvari	AAITS
littman	AAITT
90d	AAITU
QOS	AAITV
monitering	AAITW
adjusting	AAITX
FeedForward	AAITY
TIMIT	AAITZ
preprocessed	AAIUA
lyon	AAIUB
cochlear	AAIUC
ariel	AAIUD
materialized	AAIUE
GMAP	AAIUF
pro	AAIUG
cesses	AAIUH
sandewall	AAIUI
SRM	AAIUJ
acknowledgment	AAIUK
subexpressions	AAIUL
gimovsky	AAIUM
birth	AAIUN
treadmarks	AAIUO
ATOM	AAIUP
resynchronisation	AAIUQ
dsp	AAIUR
provisioning	AAIUS
multiplayer	AAIUT
discretionary	AAIUU
grasps	AAIUV
jaw	AAIUW
gripper	AAIUX
automation	AAIUY
dial	AAIUZ
arc	AAIVA
semismooth	AAIVB
nano	AAIVC
let	AAIVD
talk	AAIVE
coded	AAIVF
fetzer	AAIVG
nectar	AAIVH
backplane	AAIVI
ticomputers	AAIVJ
multicomput	AAIVK
ers	AAIVL
emerging	AAIVM
SDL	AAIVN
MSCs	AAIVO
unobservability	AAIVP
PSG	AAIVQ
arbiter	AAIVR
combiner	AAIVS
represent	AAIVT
codons	AAIVU
wright	AAIVV
HLA	AAIVW
IRIS	AAIVX
creasing	AAIVY
CCSP	AAIVZ
freeway	AAIWA
patrol	AAIWB
fsp	AAIWC
FSP	AAIWD
entailment	AAIWE
completing	AAIWF
patternsand	AAIWG
remotely	AAIWH
sensed	AAIWI
eigenvector	AAIWJ
fernando	AAIWK
wilkinson	AAIWL
knowing	AAIWM
typesetting	AAIWN
apple	AAIWO
tasting	AAIWP
systematicity	AAIWQ
presenting	AAIWR
snooping	AAIWS
regressors	AAIWT
decidability	AAIWU
multifingered	AAIWV
massive	AAIWW
linux	AAIWX
SIFT	AAIWY
ATool	AAIWZ
pie	AAIXA
sky	AAIXB
favorite	AAIXC
bipartite	AAIXD
simplicial	AAIXE
int	AAIXF
reshaping	AAIXG
locate	AAIXH
nucleic	AAIXI
acid	AAIXJ
SSA	AAIXK
factored	AAIXL
def	AAIXM
18	AAIXN
nonmonotone	AAIXO
perturbed	AAIXP
triptych	AAIXQ
crossbar	AAIXR
pojection	AAIXS
tone	AAIXT
rating	AAIXU
requirement	AAIXV
LimitLESS	AAIXW
coherency	AAIXX
migratory	AAIXY
eta	AAIXZ
FSM	AAIYA
nonzero	AAIYB
unsatisfied	AAIYC
blame	AAIYD
homotopies	AAIYE
MCPLIB	AAIYF
homotopy	AAIYG
gisting	AAIYH
am	AAIYI
40	AAIYJ
instructions	AAIYK
chewing	AAIYL
muscles	AAIYM
maxilo	AAIYN
urgery	AAIYO
delineating	AAIYP
buildings	AAIYQ
lines	AAIYR
motorola	AAIYS
68020	AAIYT
VINO	AAIYU
c/30	AAIYV
microcode	AAIYW
SDVS	AAIYX
USENIX	AAIYY
numbers	AAIYZ
ACL2	AAIZA
unrolling	AAIZB
proben1	AAIZC
calling	AAIZD
antirandom	AAIZE
getting	AAIZF
black	AAIZG
f0	AAIZH
von	AAIZI
mises	AAIZJ
concentration	AAIZK
true	AAIZL
creativity	AAIZM
mod	AAIZN
elling	AAIZO
poisson	AAIZP
circular	AAIZQ
contraction	AAIZR
sigmoid	AAIZS
JANUS	AAIZT
lu	AAIZU
overlap	AAIZV
cuppen	AAIZW
affect	AAIZX
annotation	AAIZY
NDT	AAIZZ
members	AAJAA
decorrelated	AAJAB
bumptrees	AAJAC
shard	AAJAD
mock	AAJAE
exam	AAJAF
federated	AAJAG
boundaries	AAJAH
tems	AAJAI
permanent	AAJAJ
matchings	AAJAK
spans	AAJAL
debuggers	AAJAM
reacting	AAJAN
bank	AAJAO
GAMMA	AAJAP
astrophysical	AAJAQ
kleene	AAJAR
historical	AAJAS
meteorological	AAJAT
ultrasonic	AAJAU
char	AAJAV
acterisation	AAJAW
board	AAJAX
tolerable	AAJAY
localisation	AAJAZ
mapbuilding	AAJBA
tiered	AAJBB
revising	AAJBC
formalism	AAJBD
presuppositions	AAJBE
commitments	AAJBF
assistance	AAJBG
cryptanalytic	AAJBH
ICML97	AAJBI
changeling	AAJBJ
osi	AAJBK
1277	AAJBL
add	AAJBM
DomainSpecific	AAJBN
outline	AAJBO
ET++	AAJBP
seamless	AAJBQ
jie	AAJBR
bing	AAJBS
r*	AAJBT
TDL	AAJBU
ravines	AAJBV
webs	AAJBW
archived	AAJBX
fills	AAJBY
higgens	AAJBZ
UIMS	AAJCA
CNS	AAJCB
nationwide	AAJCC
sufficiency	AAJCD
KSR1	AAJCE
periodicity	AAJCF
ok	AAJCG
spent	AAJCH
ASPLOS	AAJCI
vi	AAJCJ
executables	AAJCK
pa	AAJCL
interpreter	AAJCM
deposit	AAJCN
carpet	AAJCO
skewed	AAJCP
discriminant	AAJCQ
emotional	AAJCR
dataow	AAJCS
memorandum	AAJCT
obstacles	AAJCU
oscillatory	AAJCV
admissible	AAJCW
powerful	AAJCX
propulsion	AAJCY
sight	AAJCZ
intonation	AAJDA
segregation	AAJDB
ecg	AAJDC
observing	AAJDD
raster	AAJDE
respect	AAJDF
glue	AAJDG
nail	AAJDH
expansions	AAJDI
complement	AAJDJ
attraction	AAJDK
mediator	AAJDL
fron	AAJDM
TreeBanker	AAJDN
parsed	AAJDO
driving	AAJDP
pearance	AAJDQ
OGI	AAJDR
warehouses	AAJDS
omissions	AAJDT
maintainable	AAJDU
summarization	AAJDV
strobe	AAJDW
MultiSource	AAJDX
lookahead	AAJDY
timesharing	AAJDZ
pass	AAJEA
quantiles	AAJEB
delivering	AAJEC
telerobotics	AAJED
containment	AAJEE
pair	AAJEF
both	AAJEG
medicine	AAJEH
toolhandle	AAJEI
gases	AAJEJ
ORBs	AAJEK
binocular	AAJEL
ocular	AAJEM
dominance	AAJEN
selectivity	AAJEO
manufacturing	AAJEP
suites	AAJEQ
charts	AAJER
recoverable	AAJES
ABR	AAJET
parity	AAJEU
wont	AAJEV
away	AAJEW
guarantee	AAJEX
VirtualClock	AAJEY
psather	AAJEZ
buildable	AAJFA
censoring	AAJFB
people	AAJFC
polyinstantiation	AAJFD
multipurpose	AAJFE
mail	AAJFF
1714	AAJFG
whois	AAJFH
RWhois	AAJFI
formula	AAJFJ
CTL	AAJFK
homogeneous	AAJFL
overpartitioning	AAJFM
unpublished	AAJFN
doctoral	AAJFO
probable	AAJFP
plausible	AAJFQ
classifica	AAJFR
replica	AAJFS
analogy	AAJFT
goldman	AAJFU
biconnected	AAJFV
brill	AAJFW
psycholinguistic	AAJFX
proximal	AAJFY
earth	AAJFZ
sciences	AAJGA
integrative	AAJGB
retail	AAJGC
commerce	AAJGD
discovered	AAJGE
dedicated	AAJGF
coinduction	AAJGG
corecursion	AAJGH
higherorder	AAJGI
conformational	AAJGJ
macrocyclic	AAJGK
molecules	AAJGL
logging	AAJGM
depends	AAJGN
irrational	AAJGO
disparity	AAJGP
endsystem	AAJGQ
ACTIVE	AAJGR
papadimitriou	AAJGS
turning	AAJGT
eureka	AAJGU
critics	AAJGV
clarke	AAJGW
formalized	AAJGX
simulative	AAJGY
apprentice	AAJGZ
FAllQ	AAJHA
mass	AAJHB
inspired	AAJHC
QUINNS	AAJHD
straightforward	AAJHE
item	AAJHF
isosurface	AAJHG
targets	AAJHH
university	AAJHI
washington	AAJHJ
statement	AAJHK
homeomorphic	AAJHL
parse	AAJHM
secrecy	AAJHN
digitized	AAJHO
ot	AAJHP
interdisciplinary	AAJHQ
say	AAJHR
fluorescent	AAJHS
tracedata	AAJHT
iconic	AAJHU
syatems	AAJHV
utah	AAJHW
explaining	AAJHX
serendipitous	AAJHY
PDAs	AAJHZ
pc	AAJIA
CSR	AAJIB
simplex	AAJIC
distant	AAJID
talking	AAJIE
piano	AAJIF
movers	AAJIG
amidst	AAJIH
deofmrable	AAJII
intensity	AAJIJ
plexity	AAJIK
binaryzantine	AAJIL
crash	AAJIM
PPM	AAJIN
blending	AAJIO
reorder	AAJIP
interrupt	AAJIQ
logistic	AAJIR
speciflcations	AAJIS
MoMo	AAJIT
conic	AAJIU
attractor	AAJIV
scenario	AAJIW
memento	AAJIX
bibliographic	AAJIY
pigeonhole	AAJIZ
amplitude	AAJJA
ratios	AAJJB
temperature	AAJJC
gauge	AAJJD
ksr	AAJJE
dsa	AAJJF
analogues	AAJJG
micropower	AAJJH
HMM	AAJJI
decoder	AAJJJ
wordspotting	AAJJK
phone	AAJJL
transputers	AAJJM
auto	AAJJN
braun	AAJJO
primary	AAJJP
crosstalk	AAJJQ
maze	AAJJR
elephants	AAJJS
men	AAJJT
comptence	AAJJU
serverless	AAJJV
fifty	AAJJW
invocation	AAJJX
richards	AAJJY
analysers	AAJJZ
morphemic	AAJKA
suffixes	AAJKB
paired	AAJKC
illuminating	AAJKD
polyhedra	AAJKE
geodesic	AAJKF
triangulations	AAJKG
disorders	AAJKH
transcending	AAJKI
nogood	AAJKJ
stealing	AAJKK
COOL	AAJKL
fastest	AAJKM
west	AAJKN
synergy	AAJKO
upright	AAJKP
verted	AAJKQ
jin	AAJKR
yi	AAJKS
cai	AAJKT
OOPSLA	AAJKU
leakproof	AAJKV
ada83	AAJKW
inferred	AAJKX
triaxial	AAJKY
accelerometer	AAJKZ
sarcos	AAJLA
solaris	AAJLB
mc	AAJLC
anatomy	AAJLD
OC1	AAJLE
persistency	AAJLF
COMET	AAJLG
comet	AAJLH
srm	AAJLI
orphan	AAJLJ
wake	AAJLK
sleep	AAJLL
emotion	AAJLM
evalution	AAJLN
antiair	AAJLO
POS	AAJLP
PID	AAJLQ
declarer	AAJLR
hanson	AAJLS
MRSEV	AAJLT
CAM	AAJLU
XFS	AAJLV
standardisation	AAJLW
fm	AAJLX
1990	AAJLY
urs	AAJLZ
holzle	AAJMA
ALCHEMIST	AAJMB
KBS	AAJMC
resynthesis	AAJMD
browsers	AAJME
displacement	AAJMF
spherical	AAJMG
chunks	AAJMH
datacubes	AAJMI
lanes	AAJMJ
alleviating	AAJMK
consumption	AAJML
WormholeRouted	AAJMM
NUMA	AAJMN
muliprocessor	AAJMO
instantaneous	AAJMP
hmm	AAJMQ
XVision	AAJMR
subjective	AAJMS
youth	AAJMT
ISYS	AAJMU
probablistic	AAJMV
tresholding	AAJMW
suppression	AAJMX
nexus	AAJMY
fragmented	AAJMZ
intellectual	AAJNA
watermarking	AAJNB
edited	AAJNC
sematic	AAJND
incorporate	AAJNE
relativized	AAJNF
adve	AAJNG
vernon	AAJNH
accommodating	AAJNI
viewed	AAJNJ
viewpoints	AAJNK
syllabification	AAJNL
reply	AAJNM
criticisms	AAJNN
knight	AAJNO
leveson	AAJNP
falcon	AAJNQ
numeric	AAJNR
saturated	AAJNS
actuators	AAJNT
worked	AAJNU
longitudinal	AAJNV
skew	AAJNW
stuttering	AAJNX
elliptic	AAJNY
homomorphic	AAJNZ
sockets	AAJOA
tripathi	AAJOB
orchestrated	AAJOC
modifying	AAJOD
rulebases	AAJOE
timestamping	AAJOF
may	AAJOG
mediate	AAJOH
cortex	AAJOI
geo	AAJOJ
crashes	AAJOK
omission	AAJOL
horne	AAJOM
remembering	AAJON
IIOP	AAJOO
footprint	AAJOP
maximal	AAJOQ
subgraph	AAJOR
clairvoyance	AAJOS
tabular	AAJOT
appendix	AAJOU
datapath	AAJOV
DRAM	AAJOW
subsystems	AAJOX
codesign	AAJOY
indirection	AAJOZ
relatedness	AAJPA
advance	AAJPB
reservations	AAJPC
revisiting	AAJPD
paxos	AAJPE
assesment	AAJPF
millennium	AAJPG
worldwide	AAJPH
flock	AAJPI
condors	AAJPJ
corner	AAJPK
psychological	AAJPL
interfacing	AAJPM
condor	AAJPN
pvm	AAJPO
harness	AAJPP
nomial	AAJPQ
overloading	AAJPR
distinctions	AAJPS
evaluators	AAJPT
lsi	AAJPU
trec	AAJPV
FastMap	AAJPW
traditional	AAJPX
crl	AAJPY
trials	AAJPZ
geographical	AAJQA
robo	AAJQB
shepherd	AAJQC
STFT	AAJQD
differencing	AAJQE
HDL	AAJQF
WWWDesign	AAJQG
animals	AAJQH
animats	AAJQI
commuting	AAJQJ
tits	AAJQK
detectability	AAJQL
foster	AAJQM
mural	AAJQN
displaying	AAJQO
bambi	AAJQP
godzilla	AAJQQ
jumps	AAJQR
diamond	AAJQS
park	AAJQT
modifiability	AAJQU
joining	AAJQV
connecting	AAJQW
sitaram	AAJQX
multigraphs	AAJQY
puter	AAJQZ
galley	AAJRA
MLP	AAJRB
digits	AAJRC
DES	AAJRD
ciphers	AAJRE
invertible	AAJRF
asking	AAJRG
minimize	AAJRH
NeuroLinear	AAJRI
guardians	AAJRJ
MacGuffin	AAJRK
happen	AAJRL
dirk	AAJRM
balfanz	AAJRN
inte	AAJRO
gration	AAJRP
dialogs	AAJRQ
GLIB	AAJRR
epidemiology	AAJRS
biostatistics	AAJRT
cactus	AAJRU
automaton	AAJRV
vnode	AAJRW
13	AAJRX
INKA	AAJRY
mimd	AAJRZ
trader	AAJSA
enable	AAJSB
homogenous	AAJSC
office	AAJSD
avalanche	AAJSE
enclosure	AAJSF
mised	AAJSG
damsl	AAJSH
constituents	AAJSI
conversations	AAJSJ
polynomially	AAJSK
adrift	AAJSL
metatheory	AAJSM
mediators	AAJSN
materialization	AAJSO
surprises	AAJSP
FIRE	AAJSQ
inserting	AAJSR
cico	AAJSS
annotations	AAJST
biological	AAJSU
trolling	AAJSV
mature	AAJSW
ASICs	AAJSX
MaStA	AAJSY
db	AAJSZ
reasoned	AAJTA
somewhat	AAJTB
approxi	AAJTC
mate	AAJTD
categorial	AAJTE
contributes	AAJTF
reaching	AAJTG
movements	AAJTH
CoreLex	AAJTI
polysemy	AAJTJ
underspecification	AAJTK
mistake	AAJTL
ambiguities	AAJTM
rerouting	AAJTN
WEBVIZ	AAJTO
consequence	AAJTP
DAMN	AAJTQ
fishes	AAJTR
locomotion	AAJTS
cleaners	AAJTT
tachniques	AAJTU
exhibiting	AAJTV
prosopagnosia	AAJTW
unify	AAJTX
students	AAJTY
young	AAJTZ
scholars	AAJUA
ISR	AAJUB
p++	AAJUC
fragmentation	AAJUD
rendez	AAJUE
vous	AAJUF
justifies	AAJUG
dispersity	AAJUH
isolated	AAJUI
immune	AAJUJ
HARTS	AAJUK
IPC	AAJUL
port	AAJUM
timeliness	AAJUN
analytically	AAJUO
inductively	AAJUP
lambertian	AAJUQ
StatSci	AAJUR
20	AAJUS
horus	AAJUT
thresholding	AAJUU
exper	AAJUV
iments	AAJUW
PIRCS	AAJUX
axiomatization	AAJUY
bicoercibility	AAJUZ
typability	AAJVA
f+eta	AAJVB
mitchell	AAJVC
contructing	AAJVD
sieve	AAJVE
foor	AAJVF
authorship	AAJVG
author	AAJVH
intrusions	AAJVI
largest	AAJVJ
DSMs	AAJVK
present	AAJVL
URV	AAJVM
containing	AAJVN
smartest	AAJVO
underdetermined	AAJVP
explicet	AAJVQ
arnoldi	AAJVR
lanczos	AAJVS
turbulience	AAJVT
drives	AAJVU
grammaticality	AAJVV
cholesky	AAJVW
sparsity	AAJVX
bajcsy	AAJVY
decompostion	AAJVZ
fidelity	AAJWA
egomotion	AAJWB
similarities	AAJWC
BranchBound	AAJWD
applets	AAJWE
selfish	AAJWF
inteval	AAJWG
skip	AAJWH
scrambling	AAJWI
bursty	AAJWJ
arrival	AAJWK
intension	AAJWL
relieving	AAJWM
elaboration	AAJWN
epistasis	AAJWO
HMMs	AAJWP
letters	AAJWQ
provided	AAJWR
dictionaries	AAJWS
PLEASE	AAJWT
harvey	AAJWU
smarter	AAJWV
observational	AAJWW
paradox	AAJWX
apparent	AAJWY
evo	AAJWZ
lution	AAJXA
dpns	AAJXB
person	AAJXC
blob	AAJXD
pedestrian	AAJXE
shoot	AAJXF
logspace	AAJXG
compounds	AAJXH
timestamps	AAJXI
ix	AAJXJ
instrumented	AAJXK
eventually	AAJXL
serializable	AAJXM
inspections	AAJXN
chalkboard	AAJXO
meetings	AAJXP
ethnographic	AAJXQ
anthropometry	AAJXR
adequacy	AAJXS
VuNet	AAJXT
recommendation	AAJXU
kanellakis	AAJXV
hci	AAJXW
DOOD95	AAJXX
knowlege	AAJXY
convexity	AAJXZ
ja	AAJYA
cobians	AAJYB
unsym	AAJYC
approxima	AAJYD
subsonic	AAJYE
colorado	AAJYF
thesaurus	AAJYG
coregistration	AAJYH
eight	AAJYI
degrees	AAJYJ
se	AAJYK
mantical	AAJYL
kwasny	AAJYM
engebretson	AAJYN
penetrating	AAJYO
sculptured	AAJYP
quiescence	AAJYQ
notion	AAJYR
costas	AAJYS
courcoubetis	AAJYT
installation	AAJYU
ScaLAPACK	AAJYV
beds	AAJYW
ASOCS	AAJYX
coir	AAJYY
proximity	AAJYZ
symbiotic	AAJZA
inputs	AAJZB
correspond	AAJZC
adapt	AAJZD
fastpass	AAJZE
polylingual	AAJZF
accomodates	AAJZG
enhancements	AAJZH
mediaboard	AAJZI
increase	AAJZJ
COREVIEW	AAJZK
lived	AAJZL
renaming	AAJZM
computability	AAJZN
neuronlike	AAJZO
bove	AAJZP
semiautomatic	AAJZQ
evolvable	AAJZR
stuff	AAJZS
understand	AAJZT
unifrontal	AAJZU
unsymmetric	AAJZV
melhem	AAJZW
challenging	AAJZX
restrictions	AAJZY
critiquing	AAJZZ
TILEWORLD	AAKAA
lineage	AAKAB
cached	AAKAC
niche	AAKAD
september	AAKAE
27	AAKAF
star	AAKAG
accelerating	AAKAH
leaping	AAKAI
crit	AAKAJ
icality	AAKAK
discriminants	AAKAL
particular	AAKAM
sleeping	AAKAN
lempel	AAKAO
ziv	AAKAP
strings	AAKAQ
pic	AAKAR
complementation	AAKAS
adjectives	AAKAT
nouns	AAKAU
intelligible	AAKAV
subsorts	AAKAW
facilitate	AAKAX
pneumatic	AAKAY
EDAGs	AAKAZ
MIPS	AAKBA
GaAs	AAKBB
stronger	AAKBC
encrypted	AAKBD
discriminators	AAKBE
retrofitting	AAKBF
conjunctive	AAKBG
highspeed	AAKBH
ori	AAKBI
entable	AAKBJ
deterministically	AAKBK
interac	AAKBL
tive	AAKBM
grams	AAKBN
polyzos	AAKBO
PCNs	AAKBP
impulse	AAKBQ
ob	AAKBR
servations	AAKBS
exploits	AAKBT
FlowInsensitive	AAKBU
catching	AAKBV
bugs	AAKBW
M=M=1=K	AAKBX
clustered	AAKBY
curiosity	AAKBZ
compcon	AAKCA
purely	AAKCB
ralph	AAKCC
grishman	AAKCD
declustering	AAKCE
responding	AAKCF
informational	AAKCG
situations	AAKCH
clusterings	AAKCI
OMEGA	AAKCJ
EndPoint	AAKCK
CogPiT	AAKCL
TIP	AAKCM
national	AAKCN
cyberspace	AAKCO
prodigy	AAKCP
manage	AAKCQ
archi	AAKCR
tectures	AAKCS
intrinsic	AAKCT
bayou	AAKCU
detect	AAKCV
payment	AAKCW
unob	AAKCX
servability	AAKCY
perfectly	AAKCZ
cryptology	AAKDA
CRYPTO	AAKDB
bandwidths	AAKDC
fluids	AAKDD
mirage+	AAKDE
multimediaa	AAKDF
discussion	AAKDG
tenet	AAKDH
four	AAKDI
justification	AAKDJ
judicial	AAKDK
drafting	AAKDL
dition	AAKDM
culling	AAKDN
archive	AAKDO
focussed	AAKDP
d*	AAKDQ
replanning	AAKDR
inscribability	AAKDS
microelectrome	AAKDT
chanical	AAKDU
spectur	AAKDV
multigrain	AAKDW
precepts	AAKDX
augment	AAKDY
releases	AAKDZ
CROWNS	AAKEA
CAIP	AAKEB
spares	AAKEC
de	AAKED
ductive	AAKEE
decorrelating	AAKEF
ILU	AAKEG
fifth	AAKEH
probabilistically	AAKEI
checkable	AAKEJ
basket	AAKEK
tcl	AAKEL
tele	AAKEM
combinators	AAKEN
opti	AAKEO
mizers	AAKEP
stefano	AAKEQ
ceri	AAKER
katsumi	AAKES
tanaka	AAKET
cardinality	AAKEU
cascades	AAKEV
hinchey	AAKEW
commandments	AAKEX
STRIPS	AAKEY
ended	AAKEZ
CRAM	AAKFA
manifolds	AAKFB
misclassification	AAKFC
fraud	AAKFD
anaylysis	AAKFE
numerica	AAKFF
sophisticated	AAKFG
FA/C	AAKFH
interruptable	AAKFI
sections	AAKFJ
embeddings	AAKFK
actuation	AAKFL
polysilicon	AAKFM
exure	AAKFN
colors	AAKFO
microactuators	AAKFP
exures	AAKFQ
straightline	AAKFR
crossing	AAKFS
upward	AAKFT
fibonacci	AAKFU
dynamization	AAKFV
trapezoid	AAKFW
subdivisions	AAKFX
hermeneutics	AAKFY
explication	AAKFZ
outerplanar	AAKGA
parascope	AAKGB
arrangement	AAKGC
winner	AAKGD
linguistics	AAKGE
prospectus	AAKGF
picture	AAKGG
bitrate	AAKGH
lovasz	AAKGI
theta	AAKGJ
semidef	AAKGK
inite	AAKGL
infant	AAKGM
mortality	AAKGN
generational	AAKGO
objectoriented	AAKGP
SunOS	AAKGQ
punctuality	AAKGR
railroad	AAKGS
venus	AAKGT
ics	AAKGU
hopcp	AAKGV
spindown	AAKGW
rent	AAKGX
buy	AAKGY
variates	AAKGZ
floor	AAKHA
anomalies	AAKHB
modeled	AAKHC
dorr	AAKHD
interoperable	AAKHE
1d	AAKHF
SME	AAKHG
MS94	AAKHH
176	AAKHI
statman	AAKHJ
multicut	AAKHK
lossless	AAKHL
evaluator	AAKHM
planarity	AAKHN
MaRS	AAKHO
honesty	AAKHP
implies	AAKHQ
coprime	AAKHR
pursuits	AAKHS
exponents	AAKHT
spanned	AAKHU
balls	AAKHV
DDN	AAKHW
PDN	AAKHX
maestro	AAKHY
relatively	AAKHZ
reals	AAKIA
nimble	AAKIB
inferencer	AAKIC
84	AAKID
cocktail	AAKIE
topography	AAKIF
correla	AAKIG
tions	AAKIH
gentzen	AAKII
overcomplete	AAKIJ
damped	AAKIK
rough	AAKIL
reducts	AAKIM
interworking	AAKIN
exhaust	AAKIO
nozzle	AAKIP
foil	AAKIQ
prehistoric	AAKIR
tale	AAKIS
vir	AAKIT
tual	AAKIU
essay	AAKIV
psychology	AAKIW
paralex	AAKIX
placements	AAKIY
IFAD	AAKIZ
beach	AAKJA
contents	AAKJB
pareto	AAKJC
ALL	AAKJD
europe	AAKJE
candide	AAKJF
student	AAKJG
odd	AAKJH
even	AAKJI
parlists	AAKJJ
likelihoods	AAKJK
intractable	AAKJL
proba	AAKJM
bilities	AAKJN
internist	AAKJO
backpropogation	AAKJP
rise	AAKJQ
spurious	AAKJR
specialize	AAKJS
neuro	AAKJT
parent	AAKJU
recombination	AAKJV
binatorial	AAKJW
ity	AAKJX
multicomputing	AAKJY
multicasts	AAKJZ
TERC	AAKKA
conveying	AAKKB
intransigents	AAKKC
OO7	AAKKD
messenger	AAKKE
brightnesses	AAKKF
ELLA	AAKKG
margin	AAKKH
archie	AAKKI
homepage	AAKKJ
hollunder	AAKKK
loom	AAKKL
iPSC/2	AAKKM
DIADEM	AAKKN
automobile	AAKKO
submarine	AAKKP
varaiya	AAKKQ
SHIFT	AAKKR
matched	AAKKS
infor	AAKKT
BIRCH	AAKKU
CLEARS	AAKKV
LIFEA	AAKKW
industrially	AAKKX
proactor	AAKKY
RELFUN	AAKKZ
exclusions	AAKLA
citizens	AAKLB
RFM	AAKLC
workpiece	AAKLD
geometries	AAKLE
lathe	AAKLF
FLIP	AAKLG
rolling	AAKLH
mutable	AAKLI
MADT	AAKLJ
tos	AAKLK
viewserver	AAKLL
deny	AAKLM
novices	AAKLN
must	AAKLO
seismic	AAKLP
seis1	AAKLQ
typechecking	AAKLR
creation	AAKLS
EKSL	AAKLT
33	AAKLU
floting	AAKLV
interoperation	AAKLW
johnson	AAKLX
brian	AAKLY
FooteDesigning	AAKLZ
EDF	AAKMA
IBS	AAKMB
cycic	AAKMC
friends	AAKMD
cyc	AAKME
multifractals	AAKMF
80	AAKMG
japanese	AAKMH
chinese	AAKMI
readable	AAKMJ
RCAP2	AAKMK
MessagePassing	AAKML
parall	AAKMM
beazley	AAKMN
nyquist	AAKMO
gen	AAKMP
eration	AAKMQ
paraphrases	AAKMR
selfmonitoring	AAKMS
omnipotence	AAKMT
omniscience	AAKMU
SRADS	AAKMV
vis	AAKMW
eling	AAKMX
engi	AAKMY
neering	AAKMZ
cthread	AAKNA
editorial	AAKNB
constructs	AAKNC
completely	AAKND
bridger	AAKNE
revealing	AAKNF
ESPRIT	AAKNG
POST	AAKNH
GRES	AAKNI
NNDPA	AAKNJ
RP*	AAKNK
foreign	AAKNL
certainty	AAKNM
symbolically	AAKNN
meaningful	AAKNO
blanket	AAKNP
shestakov	AAKNQ
discontinuous	AAKNR
situational	AAKNS
awareness	AAKNT
updated	AAKNU
repeat	AAKNV
SOAR	AAKNW
isocontouring	AAKNX
interactivity	AAKNY
cql	AAKNZ
WebGlimpse	AAKOA
surfing	AAKOB
hy+	AAKOC
scattered	AAKOD
shifts	AAKOE
platoon	AAKOF
godbole	AAKOG
lygeros	AAKOH
frequently	AAKOI
asked	AAKOJ
today	AAKOK
newly	AAKOL
invented	AAKOM
superlinear	AAKON
pointwise	AAKOO
formalising	AAKOP
yardstick	AAKOQ
IBL	AAKOR
gorithm	AAKOS
cardinal	AAKOT
emerald	AAKOU
amber	AAKOV
tier	AAKOW
invalidations	AAKOX
deferred	AAKOY
anchored	AAKOZ
scaled	AAKPA
cones	AAKPB
compensated	AAKPC
accelerated	AAKPD
podelski	AAKPE
disentailment	AAKPF
copyright	AAKPG
publishing	AAKPH
narrow	AAKPI
passages	AAKPJ
strictness	AAKPK
unsupevised	AAKPL
MIN	AAKPM
church	AAKPN
rosser	AAKPO
porting	AAKPP
extent	AAKPQ
transliteration	AAKPR
circumscription	AAKPS
picocellular	AAKPT
periods	AAKPU
palindromes	AAKPV
schutzenberger	AAKPW
main	AAKPX
wormwhole	AAKPY
isoperimetric	AAKPZ
monomer	AAKQA
dimer	AAKQB
coverings	AAKQC
reminding	AAKQD
reconsidered	AAKQE
opt++	AAKQF
optimi	AAKQG
zation	AAKQH
miranker	AAKQI
VenusDB	AAKQJ
triggers	AAKQK
tupleware	AAKQL
preknowledge	AAKQM
uniformly	AAKQN
ergodic	AAKQO
stopping	AAKQP
diffusions	AAKQQ
3SAT	AAKQR
protocol1994	AAKQS
SigMetrics	AAKQT
forth	AAKQU
coming	AAKQV
dataset1	AAKQW
described	AAKQX
norsys	AAKQY
corp	AAKQZ
dataset2	AAKRA
david	AAKRB
heckerman	AAKRC
dataset3	AAKRD
gregory	AAKRE
cooper	AAKRF
edward	AAKRG
herskovits	AAKRH
ci	AAKRI
grouped	AAKRJ
cardinalities	AAKRK
conditionsets	AAKRL
IBM	AAKRM
inherent	AAKRN
inaccuracy	AAKRO
eigen	AAKRP
wigner	AAKRQ
determenistic	AAKRR
GLOBECOM	AAKRS
vsion	AAKRT
translations	AAKRU
peaks	AAKRV
ITS	AAKRW
interchange	AAKRX
PIF	AAKRY
campaign	AAKRZ
microsoft	AAKSA
telescoping	AAKSB
bin	AAKSC
activations	AAKSD
spinning	AAKSE
vertical	AAKSF
infinitesimal	AAKSG
decremental	AAKSH
italiano	AAKSI
amortized	AAKSJ
impossibility	AAKSK
started	AAKSL
byzan	AAKSM
tine	AAKSN
nonuniform	AAKSO
SMPs	AAKSP
arrangements	AAKSQ
expanders	AAKSR
beat	AAKSS
overlay	AAKST
suggestion	AAKSU
encrypt	AAKSV
subquadratic	AAKSW
proportionate	AAKSX
console	AAKSY
RenderMan	AAKSZ
shaders	AAKTA
spacefilling	AAKTB
blockwise	AAKTC
isotropic	AAKTD
derivational	AAKTE
RenderManPractice	AAKTF
compliance	AAKTG
maker	AAKTH
protec	AAKTI
stabilizers	AAKTJ
additive	AAKTK
gf	AAKTL
packings	AAKTM
grassmannian	AAKTN
glossy	AAKTO
website	AAKTP
att	AAKTQ
silent	AAKTR
daptive	AAKTS
marking	AAKTT
tiling	AAKTU
avoid	AAKTV
believers	AAKTW
mechanims	AAKTX
VMP	AAKTY
NAB	AAKTZ
interpolatory	AAKUA
subdivision	AAKUB
quadrilateral	AAKUC
nonconvex	AAKUD
subject	AAKUE
antecedents	AAKUF
fsm	AAKUG
um	AAKUH
translog	AAKUI
benchmarkingof	AAKUJ
HTN	AAKUK
expres	AAKUL
sivity	AAKUM
blocked	AAKUN
sensical	AAKUO
interests	AAKUP
tc	AAKUQ
plib	AAKUR
compar	AAKUS
isons	AAKUT
tahoe	AAKUU
reno	AAKUV
sack	AAKUW
PacketSwitched	AAKUX
microprogrammable	AAKUY
troller	AAKUZ
subsump	AAKVA
redesigning	AAKVB
reviews	AAKVC
CASCON	AAKVD
specular	AAKVE
kqml	AAKVF
extensibility	AAKVG
evocation	AAKVH
momentum	AAKVI
sper	AAKVJ
hical	AAKVK
pendulum	AAKVL
workspace	AAKVM
multibody	AAKVN
biped	AAKVO
baroreceptors	AAKVP
pressure	AAKVQ
transduction	AAKVR
filaments	AAKVS
LCM	AAKVT
CMMD	AAKVU
preprocessor	AAKVV
improvements	AAKVW
evaludation	AAKVX
purity	AAKVY
emotions	AAKVZ
explor	AAKWA
ation	AAKWB
everyday	AAKWC
shell	AAKWD
replacements	AAKWE
converter	AAKWF
gosset	AAKWG
testability	AAKWH
instrumental	AAKWI
reader	AAKWJ
writer	AAKWK
biosequence	AAKWL
montel	AAKWM
integers	AAKWN
preserve	AAKWO
hospital	AAKWP
autoregressive	AAKWQ
ities	AAKWR
auxiliary	AAKWS
stationary	AAKWT
neurological	AAKWU
ISDS	AAKWV
a20	AAKWW
handset	AAKWX
prolongations	AAKWY
HOP	AAKWZ
amalgating	AAKXA
TAU93	AAKXB
r3000	AAKXC
p2	AAKXD
hypersonic	AAKXE
inlet	AAKXF
cryptanalysis	AAKXG
knowledgebase	AAKXH
searls	AAKXI
optimisations	AAKXJ
applic	AAKXK
gamma	AAKXL
munch	AAKXM
tokenization	AAKXN
winograd	AAKXO
multiply	AAKXP
uniproces	AAKXQ
rollforward	AAKXR
specitcation	AAKXS
veritcation	AAKXT
maximally	AAKXU
covered	AAKXV
polytopes	AAKXW
SOLAR	AAKXX
gramming	AAKXY
tacoma	AAKXZ
broad	AAKYA
TACOMA	AAKYB
analogies	AAKYC
tightly	AAKYD
rhythmic	AAKYE
oscillators	AAKYF
fad	AAKYG
braid	AAKYH
PCS	AAKYI
reserved	AAKYJ
galileo	AAKYK
soccer	AAKYL
resolve	AAKYM
ambiguitiesa	AAKYN
sr	AAKYO
contest	AAKYP
cartographic	AAKYQ
galleries	AAKYR
MERL	AAKYS
october	AAKYT
MultiUser	AAKYU
DART	AAKYV
deforestation	AAKYW
atm	AAKYX
following	AAKYY
snapshot	AAKYZ
initiators	AAKZA
ann	AAKZB
phylogeny	AAKZC
triangulating	AAKZD
colored	AAKZE
requires	AAKZF
pedestrians	AAKZG
tabu	AAKZH
NHL	AAKZI
brigade	AAKZJ
apportionment	AAKZK
makes	AAKZL
IlliGAL	AAKZM
generality	AAKZN
will	AAKZO
outperform	AAKZP
stephanie	AAKZQ
forrest	AAKZR
rasta	AAKZS
plp	AAKZT
razor	AAKZU
DeLaY	AAKZV
clocked	AAKZW
periphery	AAKZX
subordinate	AAKZY
algortihms	AAKZZ
cliques	AALAA
memetic	AALAB
eigenvectors	AALAC
ga	AALAD
individuals	AALAE
cs	AALAF
198	AALAG
superior	AALAH
collocation	AALAI
eiben	AALAJ
schippers	AALAK
crossovers	AALAL
nk	AALAM
BDDs	AALAN
hazards	AALAO
productive	AALAP
instructive	AALAQ
beginning	AALAR
185	AALAS
inc	AALAT
intent	AALAU
txed	AALAV
neuron	AALAW
phenotypical	AALAX
blocks	AALAY
finely	AALAZ
cretized	AALBA
SIP	AALBB
jian	AALBC
zhou	AALBD
TRON	AALBE
nonde	AALBF
terminism	AALBG
limiting	AALBH
dag	AALBI
singularity	AALBJ
incompressible	AALBK
sheets	AALBL
axisymmetric	AALBM
swirling	AALBN
penn	AALBO
treebank	AALBP
annotating	AALBQ
jepson	AALBR
heeger	AALBS
retraining	AALBT
ANSWER	AALBU
analyzability	AALBV
fresh	AALBW
marketplace	AALBX
buying	AALBY
selling	AALBZ
goods	AALCA
exporting	AALCB
providers	AALCC
influencing	AALCD
incidence	AALCE
incompletely	AALCF
hamiltonian	AALCG
gutin	AALCH
digraphs	AALCI
digraph	AALCJ
hamilto	AALCK
nian	AALCL
hamilton	AALCM
semicomplete	AALCN
heaviest	AALCO
exogenous	AALCP
pancyclic	AALCQ
multipartite	AALCR
occurrences	AALCS
narratives	AALCT
hampshire	AALCU
craps	AALCV
reversing	AALCW
RED	AALCX
custom	AALCY
disambiguating	AALCZ
senses	AALDA
instances	AALDB
uncapacitated	AALDC
kostant	AALDD
cohomology	AALDE
g=b	AALDF
monochromatic	AALDG
schur	AALDH
triples	AALDI
modelled	AALDJ
asymptotics	AALDK
lagrange	AALDL
eager	AALDM
2SAT	AALDN
DICUT	AALDO
slg	AALDP
wam	AALDQ
keyhole	AALDR
adventure	AALDS
reactions	AALDT
imitation	AALDU
embodiment	AALDV
KAN	AALDW
TRA	AALDX
tolerances	AALDY
arcing	AALDZ
producing	AALEA
retaining	AALEB
significance	AALEC
ings	AALED
pr	AALEE
kb	AALEF
localness	AALEG
genericity	AALEH
femoral	AALEI
neck	AALEJ
fracture	AALEK
tackling	AALEL
generations	AALEM
ANALYSIS	AALEN
HIERARCHICAL	AALEO
GENETIC	AALEP
PROGRAMMING	AALEQ
paradigmatic	AALER
ge	AALES
netic	AALET
canonic	AALEU
causes	AALEV
bloat	AALEW
hopfield	AALEX
schoenberg	AALEY
transportation	AALEZ
altering	AALFA
brodersen	AALFB
terminal	AALFC
publications	AALFD
gp	AALFE
raters	AALFF
multitolerance	AALFG
ants	AALFH
pursuer	AALFI
evader	AALFJ
TPBVP	AALFK
SGI	AALFL
150	AALFM
MHZ	AALFN
r4400	AALFO
COLROW	AALFP
commonly	AALFQ
ABD	AALFR
included	AALFS
transistion	AALFT
NuMesh	AALFU
jamshidi	AALFV
sigma	AALFW
pi	AALFX
BioX++	AALFY
conceptions	AALFZ
biotechnological	AALGA
customer	AALGB
retention	AALGC
kol	AALGD
mogorov	AALGE
arbitrators	AALGF
cray	AALGG
t3d	AALGH
supercomputer	AALGI
MPD	AALGJ
hypercode	AALGK
enveloping	AALGL
participants	AALGM
noweb	AALGN
hacker	AALGO
xlisp	AALGP
stat	AALGQ
wiresizing	AALGR
elmore	AALGS
appliation	AALGT
boeing	AALGU
MetaLevel	AALGV
LADSEB	AALGW
CNR	AALGX
saliency	AALGY
closeness	AALGZ
homing	AALHA
tagged	AALHB
texts	AALHC
lacking	AALHD
DTD	AALHE
multicategory	AALHF
structurs	AALHG
ProcessEngine	AALHH
attitudes	AALHI
cosmic	AALHJ
hits	AALHK
ble	AALHL
telescope	AALHM
MSc	AALHN
watching	AALHO
scotch	AALHP
recoverability	AALHQ
henshaw	AALHR
hp	AALHS
AutoRAID	AALHT
SCSI	AALHU
firing	AALHV
metarule	AALHW
granularities	AALHX
flocks	AALHY
defensive	AALHZ
logs	AALIA
DBLearn	AALIB
recursions	AALIC
LanguageProceedings	AALID
queens	AALIE
visualisation	AALIF
agricultural	AALIG
CuPit	AALIH
literate	AALII
giloi	AALIJ
cameras	AALIK
employee	AALIL
timetabling	AALIM
fusing	AALIN
reprocessings	AALIO
examining	AALIP
gigabyte	AALIQ
seventeenth	AALIR
annual	AALIS
compressing	AALIT
inferences	AALIU
catenable	AALIV
nonphotorealistic	AALIW
fly	AALIX
throughs	AALIY
inefficiency	AALIZ
parametricity	AALJA
centers	AALJB
smale	AALJC
lauritzen	AALJD
spiegelhalter	AALJE
confluent	AALJF
preorder	AALJG
eddy	AALJH
currents	AALJI
performing	AALJJ
speical	AALJK
puters	AALJL
CSD	AALJM
940034	AALJN
krylov	AALJO
BioSCAN	AALJP
sharable	AALJQ
viability	AALJR
landscape	AALJS
productivity	AALJT
scott	AALJU
modularisation	AALJV
specia	AALJW
channaels	AALJX
catamorphisms	AALJY
australian	AALJZ
matters	AALKA
organisms	AALKB
jong	AALKC
coevolutionary	AALKD
functors	AALKE
intertwined	AALKF
spirals	AALKG
ups	AALKH
upcalls	AALKI
frobenius	AALKJ
dimers	AALKK
shadowing	AALKL
harmonic	AALKM
gear	AALKN
dyanamic	AALKO
fashioned	AALKP
recipe	AALKQ
collectors	AALKR
remembered	AALKS
also	AALKT
packaging	AALKU
red	AALKV
queen	AALKW
DDD	AALKX
annular	AALKY
buried	AALKZ
stale	AALLA
LISP	AALLB
metatheorems	AALLC
convertibility	AALLD
CPS	AALLE
carvings	AALLF
sethi	AALLG
ullman	AALLH
suif	AALLI
zephyra	AALLJ
returns	AALLK
MESSENGERS	AALLL
KornShell	AALLM
chips	AALLN
remember	AALLO
multimessage	AALLP
transfers	AALLQ
singh	AALLR
AND	AALLS
composability	AALLT
bars	AALLU
alexandria	AALLV
wanderlust	AALLW
sexual	AALLX
fundamentally	AALLY
HeNCE	AALLZ
MELL	AALMA
existentially	AALMB
quantified	AALMC
ames	AALMD
belongs	AALME
subsumbtion	AALMF
algorith	AALMG
nonatomic	AALMH
ations	AALMI
realise	AALMJ
LANL	AALMK
compendium	AALML
recursively	AALMM
enumerable	AALMN
isotach	AALMO
myrinet	AALMP
zephyr	AALMQ
safely	AALMR
tui	AALMS
elevator	AALMT
merits	AALMU
DIS	AALMV
wulf	AALMW
landon	AALMX
streamed	AALMY
gaussianity	AALMZ
sustained	AALNA
portion	AALNB
modulating	AALNC
ADAMS	AALND
polyspectral	AALNE
MachineDependent	AALNF
coalescing	AALNG
interfering	AALNH
GVT	AALNI
unsupervise	AALNJ
aggressive	AALNK
recombining	AALNL
congress	AALNM
CONnection	AALNN
RESolution	AALNO
wexler	AALNP
distal	AALNQ
lf	AALNR
intensions	AALNS
ELFS	AALNT
observatory	AALNU
NRAO	AALNV
caelum	AALNW
CSCW	AALNX
newsletter	AALNY
pads	AALNZ
latches	AALOA
elemental	AALOB
preemptable	AALOC
successful	AALOD
exceptionally	AALOE
insect	AALOF
beavior	AALOG
leave	AALOH
dialogical	AALOI
prerecorded	AALOJ
presburger	AALOK
formulating	AALOL
applicative	AALOM
introns	AALON
glucose	AALOO
diabetic	AALOP
ignorant	AALOQ
contrast	AALOR
nonsmooth	AALOS
lottery	AALOT
tickets	AALOU
micropayments	AALOV
puzzles	AALOW
unlinkable	AALOX
cash	AALOY
orr	AALOZ
muller	AALPA
enhancer	AALPB
dexterous	AALPC
failstop	AALPD
FailStop	AALPE
ModSAF	AALPF
radiosurgery	AALPG
sequel	AALPH
care	AALPI
informatics	AALPJ
sooner	AALPK
safer	AALPL
later	AALPM
optimising	AALPN
ffi	AALPO
CNN	AALPP
collisions	AALPQ
visuall	AALPR
pursue	AALPS
optic	AALPT
attitude	AALPU
satellites	AALPV
pilot	AALPW
straight	AALPX
iso	AALPY
guideline	AALPZ
therapy	AALQA
ongoing	AALQB
trauma	AALQC
going	AALQD
spacers	AALQE
sensible	AALQF
FIDO	AALQG
prelude	AALQH
duration	AALQI
sublexical	AALQJ
angie	AALQK
ANGIE	AALQL
morpho	AALQM
superiority	AALQN
balian	AALQO
quadrature	AALQP
preconditioner	AALQQ
perturbations	AALQR
banach	AALQS
cosine	AALQT
modulated	AALQU
FIR	AALQV
satisfying	AALQW
vulnerabilities	AALQX
COPS	AALQY
tripwire	AALQZ
quadtree	AALRA
considering	AALRB
uncovered	AALRC
vaguelette	AALRD
multiresolu	AALRE
covariances	AALRF
waveshrink	AALRG
detached	AALRH
thresholds	AALRI
densities	AALRJ
fibers	AALRK
meshing	AALRL
societies	AALRM
misconception	AALRN
reciprocative	AALRO
island	AALRP
disruption	AALRQ
edge	AALRR
CARMEL	AALRS
span	AALRT
UMDL	AALRU
agile	AALRV
interdependencies	AALRW
techiniques	AALRX
prove	AALRY
TAEMS	AALRZ
stress	AALSA
steal	AALSB
AccountWhy	AALSC
INOUT	AALSD
passed	AALSE
metacircular	AALSF
SUBTYPEP	AALSG
coordinate	AALSH
SEARCH	AALSI
bitvectors	AALSJ
FLARE	AALSK
reusability	AALSL
subgoal	AALSM
anomaly	AALSN
devising	AALSO
slider	AALSP
eiffel	AALSQ
MOOD	AALSR
disribution	AALSS
distinction	AALST
filling	AALSU
staged	AALSV
injection	AALSW
CUM	AALSX
SUM	AALSY
plots	AALSZ
teleological	AALTA
radical	AALTB
novelty	AALTC
decomposable	AALTD
MCMC	AALTE
reviewww	AALTF
hastings	AALTG
help	AALTH
DTRE	AALTI
normalizing	AALTJ
horizontal	AALTK
regeneration	AALTL
minorization	AALTM
gibbs	AALTN
james	AALTO
stein	AALTP
cad	AALTQ
ergodicity	AALTR
unknwon	AALTS
MARS	AALTT
bumping	AALTU
induced	AALTV
harris	AALTW
outperforming	AALTX
neighbour	AALTY
central	AALTZ
regenerative	AALUA
quantative	AALUB
morgan	AALUC
kaufmann	AALUD
21	AALUE
hudak	AALUF
throw	AALUG
impatient	AALUH
reinforcements	AALUI
langevin	AALUJ
EBG	AALUK
harmfulness	AALUL
deductively	AALUM
spreadsheets	AALUN
exchangeability	AALUO
muscle	AALUP
ker	AALUQ
beros	AALUR
IRT	AALUS
candidates	AALUT
subgeometric	AALUU
changepoint	AALUV
orgy	AALUW
reproduction	AALUX
lem	AALUY
steady	AALUZ
pearson	AALVA
MacDonald	AALVB
cannot	AALVC
mems	AALVD
vibratory	AALVE
niching	AALVF
mehtod	AALVG
compared	AALVH
SAT	AALVI
internetworking	AALVJ
maneuver	AALVK
formotion	AALVL
corticogeniculate	AALVM
figure	AALVN
succeed	AALVO
fruitful	AALVP
roadmaps	AALVQ
cope	AALVR
degenerate	AALVS
hypercubical	AALVT
LBG	AALVU
u	AALVV
YAILS	AALVW
LIACC	AALVX
alewife	AALVY
intervalizing	AALVZ
yoav	AALWA
shoham	AALWB
diploid	AALWC
genotype	AALWD
erative	AALWE
phenotypic	AALWF
ra	AALWG
diosity	AALWH
EBL	AALWI
articles	AALWJ
allocated	AALWK
notational	AALWL
money	AALWM
indicators	AALWN
chebyshev	AALWO
iceberg	AALWP
effciently	AALWQ
replicas	AALWR
ranks	AALWS
dutch	AALWT
diminutives	AALWU
NLP	AALWV
clp	AALWW
regularities	AALWX
ImpUnity	AALWY
leads	AALWZ
kennedy	AALXA
exterminate	AALXB
atp	AALXC
expertise	AALXD
KADS	AALXE
pessimistic	AALXF
sweeping	AALXG
lexicographic	AALXH
addition	AALXI
viewsheds	AALXJ
tioga	AALXK
hessian	AALXL
secant	AALXM
polytope	AALXN
INEXACT	AALXO
TRIP	AALXP
ALGORITHMS	AALXQ
32	AALXR
larger	AALXS
ISAKMP	AALXT
pictures	AALXU
bilingual	AALXV
degeneracies	AALXW
MissionLab	AALXX
CVGIP	AALXY
alloc	AALXZ
customization	AALYA
lite	AALYB
brooks	AALYC
magazine	AALYD
looseness	AALYE
ULV	AALYF
opus	AALYG
choices	AALYH
resnik	AALYI
ANLP	AALYJ
anova	AALYK
examine	AALYL
progression	AALYM
retinopathy	AALYN
concious	AALYO
spreadsheet	AALYP
garnet	AALYQ
approaching	AALYR
delivered	AALYS
replications	AALYT
stacks	AALYU
polarization	AALYV
hit	AALYW
converse	AALYX
ramsey	AALYY
oberon	AALYZ
montages	AALZA
OBDD	AALZB
ATP	AALZC
q3	AALZD
leap	AALZE
biased	AALZF
maxima	AALZG
prop	AALZH
erties	AALZI
subcontracts	AALZJ
immutable	AALZK
formally	AALZL
verifiable	AALZM
certifier	AALZN
mergeable	AALZO
estimated	AALZP
reformalization	AALZQ
QSIM	AALZR
raid	AALZS
computingmany	AALZT
ethical	AALZU
semiotics	AALZV
ProofWebs	AALZW
formality	AALZX
informality	AALZY
sheaf	AALZZ
elicitation	AAMAA
koza	AAMAB
microengines	AAMAC
outboard	AAMAD
buffering	AAMAE
checksumming	AAMAF
HOPE	AAMAG
subsequential	AAMAH
END	AAMAI
ParPre	AAMAJ
attractors	AAMAK
repairing	AAMAL
variety	AAMAM
nonparamteric	AAMAN
cataloging	AAMAO
priming	AAMAP
reversal	AAMAQ
VISOR	AAMAR
DeVeaux	AAMAS
LVCSR	AAMAT
exploting	AAMAU
send	AAMAV
receive	AAMAW
seriously	AAMAX
hyperparameter	AAMAY
a03	AAMAZ
sharpe	AAMBA
hexagonal	AAMBB
netowrks	AAMBC
ABSTRIPS	AAMBD
JPEG	AAMBE
separately	AAMBF
binarization	AAMBG
4th	AAMBH
trimmed	AAMBI
nurbs	AAMBJ
pick	AAMBK
ef	AAMBL
fectively	AAMBM
xylomenos	AAMBN
evaluations	AAMBO
transpose	AAMBP
suggestions	AAMBQ
undo	AAMBR
redo	AAMBS
manufacturability	AAMBT
gurevich	AAMBU
schonhage	AAMBV
cause	AAMBW
unanticipated	AAMBX
member	AAMBY
FElt	AAMBZ
solid	AAMCA
customizability	AAMCB
GOMS	AAMCC
ools	AAMCD
recycled	AAMCE
pipelin	AAMCF
incrementality	AAMCG
rame	AAMCH
oil	AAMCI
reservoir	AAMCJ
sobolev	AAMCK
BSD4	AAMCL
CBC	AAMCM
negligible	AAMCN
certifying	AAMCO
slotted	AAMCP
ALOHA	AAMCQ
TDD	AAMCR
substructures	AAMCS
semaphore	AAMCT
NOSSDAV	AAMCU
equilibrium	AAMCV
securities	AAMCW
compilative	AAMCX
economics	AAMCY
consciousness	AAMCZ
retinal	AAMDA
multicriteria	AAMDB
ophthalmological	AAMDC
shopping	AAMDD
scarce	AAMDE
keep	AAMDF
theoretc	AAMDG
introspection	AAMDH
parametrization	AAMDI
SAM	AAMDJ
HMMER	AAMDK
maximize	AAMDL
linked	AAMDM
material	AAMDN
modernization	AAMDO
KeLP	AAMDP
SAS	AAMDQ
slowdown	AAMDR
imbalance	AAMDS
MPP	AAMDT
millisecond	AAMDU
barn	AAMDV
owl	AAMDW
pathway	AAMDX
corrolations	AAMDY
implemetation	AAMDZ
determine	AAMEA
clocking	AAMEB
LCP	AAMEC
pardalos	AAMED
manifold	AAMEE
epidemiological	AAMEF
parametic	AAMEG
genmp	AAMEH
helps	AAMEI
bellows	AAMEJ
stills	AAMEK
modalities	AAMEL
quantities	AAMEM
tractor	AAMEN
capacitated	AAMEO
phylogenies	AAMEP
aboutness	AAMEQ
supervisory	AAMER
salable	AAMES
absorption	AAMET
electricity	AAMEU
ICL	AAMEV
chirplet	AAMEW
uplink	AAMEX
isnt	AAMEY
slope	AAMEZ
thin	AAMFA
tourist	AAMFB
pressionless	AAMFC
congenital	AAMFD
label	AAMFE
obstructions	AAMFF
fence	AAMFG
practicable	AAMFH
stereolithography	AAMFI
cichocki	AAMFJ
abed	AAMFK
meraim	AAMFL
ka	AAMFM
CardosoOn	AAMFN
collaboratory	AAMFO
manohar	AAMFP
atul	AAMFQ
prakash	AAMFR
birmingham	AAMFS
precomputa	AAMFT
graphic	AAMFU
rendezvous	AAMFV
troubleshooting	AAMFW
coordinated	AAMFX
CSRS	AAMFY
sequentially	AAMFZ
success	AAMGA
muse	AAMGB
ASMs	AAMGC
microcoded	AAMGD
arora	AAMGE
ASM	AAMGF
++	AAMGG
nominals	AAMGH
gure	AAMGI
vich	AAMGJ
multicarrier	AAMGK
moyne	AAMGL
runto	AAMGM
white	AAMGN
masking	AAMGO
premission	AAMGP
mi	AAMGQ
crokernel	AAMGR
bellman	AAMGS
ford	AAMGT
DFM	AAMGU
bending	AAMGV
rom	AAMGW
hpsg	AAMGX
appointment	AAMGY
af	AAMGZ
GDTFD	AAMHA
spectrogram	AAMHB
existance	AAMHC
quartic	AAMHD
situ	AAMHE
etch	AAMHF
semiconductor	AAMHG
materials	AAMHH
held	AAMHI
30	AAMHJ
ultrasound	AAMHK
thermotherapy	AAMHL
invasive	AAMHM
mismatches	AAMHN
techn	AAMHO
YAC	AAMHP
cosmid	AAMHQ
contig	AAMHR
groupings	AAMHS
urgent	AAMHT
PCN	AAMHU
routability	AAMHV
detailed	AAMHW
ontolingua	AAMHX
film	AAMHY
microdevices	AAMHZ
dr	AAMIA
hide	AAMIB
infrastructures	AAMIC
penalties	AAMID
preconditioning	AAMIE
emission	AAMIF
tomography	AAMIG
ascent	AAMIH
cramer	AAMII
rao	AAMIJ
covariance	AAMIK
gradientalgorithm	AAMIL
tomographic	AAMIM
scans	AAMIN
such	AAMIO
ASPIRE	AAMIP
cr	AAMIQ
MAP	AAMIR
bootstraping	AAMIS
seeding	AAMIT
imposed	AAMIU
conditioned	AAMIV
plants	AAMIW
positron	AAMIX
randoms	AAMIY
precorrected	AAMIZ
timeout	AAMJA
SRAM	AAMJB
multiway	AAMJC
RIO	AAMJD
penetration	AAMJE
slots	AAMJF
conducting	AAMJG
cylinders	AAMJH
te	AAMJI
hope	AAMJJ
realized	AAMJK
bitmap	AAMJL
supernet	AAMJM
begin	AAMJN
standardization	AAMJO
gypsy	AAMJP
filtered	AAMJQ
backprojection	AAMJR
WebFS	AAMJS
nmr	AAMJT
skyscraper	AAMJU
SSH	AAMJV
login	AAMJW
michael	AAMJX
rabinovich	AAMJY
ramp	AAMJZ
hypergraph	AAMKA
regional	AAMKB
ERS	AAMKC
JERS	AAMKD
PORTS	AAMKE
segmenting	AAMKF
majorization	AAMKG
greed	AAMKH
huffman	AAMKI
submodular	AAMKJ
aesthetics	AAMKK
LEDA	AAMKL
randomizing	AAMKM
fft	AAMKN
systolic	AAMKO
gauss	AAMKP
jordan	AAMKQ
haynsworth	AAMKR
quotient	AAMKS
complements	AAMKT
subspaces	AAMKU
warren	AAMKV
bershad	AAMKW
shadow	AAMKX
guarding	AAMKY
afford	AAMKZ
subopti	AAMLA
mality	AAMLB
brachiation	AAMLC
datamining	AAMLD
ESOP	AAMLE
beamforming	AAMLF
slow	AAMLG
conrol	AAMLH
ion	AAMLI
etching	AAMLJ
geocod	AAMLK
SAR	AAMLL
composites	AAMLM
ward	AAMLN
geophysical	AAMLO
AVPNs	AAMLP
AMANDA	AAMLQ
drill	AAMLR
JaDE	AAMLS
psychophysics	AAMLT
senso	AAMLU
rimotor	AAMLV
nonadaptive	AAMLW
exogeneity	AAMLX
century	AAMLY
age	AAMLZ
confounding	AAMMA
neuman	AAMMB
tso	AAMMC
FLUX	AAMMD
inodes	AAMME
groupiing	AAMMF
verfication	AAMMG
actual	AAMMH
bachelor	AAMMI
CMS	AAMMJ
trigger	AAMMK
electron	AAMML
photon	AAMMM
calorimeter	AAMMN
steerable	AAMMO
compactable	AAMMP
ascertaining	AAMMQ
flowback	AAMMR
RLC	AAMMS
pcb	AAMMT
mcm	AAMMU
fp	AAMMV
LUTs	AAMMW
submicron	AAMMX
stokes	AAMMY
mbp	AAMMZ
t0	AAMNA
fix	AAMNB
font	AAMNC
ber	AAMND
muda	AAMNE
efiective	AAMNF
featherweight	AAMNG
odometric	AAMNH
CORAL	AAMNI
PotkonjakMinimizing	AAMNJ
API	AAMNK
checks	AAMNL
jgraph	AAMNM
PostScript	AAMNN
faber	AAMNO
landweber	AAMNP
subscript	AAMNQ
firm	AAMNR
acrobot	AAMNS
proper	AAMNT
arborescence	AAMNU
SAMeDL	AAMNV
metapattern	AAMNW
TDM	AAMNX
ook	AAMNY
arborescenceproblem	AAMNZ
lumigraph	AAMOA
extend	AAMOB
keyed	AAMOC
SDC	AAMOD
dempster	AAMOE
shafer	AAMOF
magnetohydrodynamic	AAMOG
detonation	AAMOH
exponent	AAMOI
glass	AAMOJ
negated	AAMOK
neurally	AAMOL
motivated	AAMOM
reflexive	AAMON
interest	AAMOO
verbal	AAMOP
aspect	AAMOQ
leake	AAMOR
CSLU	AAMOS
nineties	AAMOT
syllable	AAMOU
ART	AAMOV
mayr	AAMOW
analyser	AAMOX
miniature	AAMOY
MultiSpert	AAMOZ
speakers	AAMPA
antidotes	AAMPB
ASR	AAMPC
primes	AAMPD
million	AAMPE
manifesto	AAMPF
ICSI	AAMPG
egret	AAMPH
navigator	AAMPI
IIR	AAMPJ
magnitude	AAMPK
ICEC96	AAMPL
evolutio	AAMPM
coins	AAMPN
encription	AAMPO
5/4	AAMPP
institute	AAMPQ
tur	AAMPR
pronged	AAMPS
TapeResident	AAMPT
currency	AAMPU
cardiac	AAMPV
mri	AAMPW
underconstrained	AAMPX
harp	AAMPY
ARCH	AAMPZ
PEACE	AAMQA
14	AAMQB
kohonen	AAMQC
logarithmus	AAMQD
exponentials	AAMQE
RippleDown	AAMQF
ANN	AAMQG
competence	AAMQH
microdomain	AAMQI
alphabet	AAMQJ
KARMA	AAMQK
grip	AAMQL
ICLA	AAMQM
CRMA	AAMQN
swizzle	AAMQO
comeptitive	AAMQP
agorithms	AAMQQ
discretely	AAMQR
actuated	AAMQS
RMS	AAMQT
pronunciations	AAMQU
ESCA	AAMQV
ostrovsky	AAMQW
PJama	AAMQX
zeroes	AAMQY
orca	AAMQZ
microkernels	AAMRA
shokrollahi	AAMRB
prime	AAMRC
divisors	AAMRD
congruence	AAMRE
divisor	AAMRF
doing	AAMRG
MPMD	AAMRH
dataman	AAMRI
baltzer	AAMRJ
info	AAMRK
stations	AAMRL
commensurable	AAMRM
CrossDomain	AAMRN
ssa	AAMRO
haskore	AAMRP
tenth	AAMRQ
edition	AAMRR
decimation	AAMRS
VCODE	AAMRT
satisfic	AAMRU
triplets	AAMRV
suffice	AAMRW
alone	AAMRX
cool	AAMRY
HOT	AAMRZ
scheiblechner	AAMSA
ISOP	AAMSB
unidimensional	AAMSC
coregis	AAMSD
tering	AAMSE
malloc	AAMSF
spine	AAMSG
spineless	AAMSH
tagless	AAMSI
revertible	AAMSJ
blackholes	AAMSK
fudgets	AAMSL
symmetries	AAMSM
antisymmetries	AAMSN
SSOR	AAMSO
preconditionings	AAMSP
AP1000	AAMSQ
radiometric	AAMSR
flame	AAMSS
convolved	AAMST
DALI	AAMSU
electro	AAMSV
fringe	AAMSW
photography	AAMSX
archetype	AAMSY
holograms	AAMSZ
disabled	AAMTA
estimate	AAMTB
knot	AAMTC
ADL	AAMTD
disfluencies	AAMTE
plasma	AAMTF
reactors	AAMTG
hawk	AAMTH
teleconferencing	AAMTI
timegraph	AAMTJ
entire	AAMTK
brodatz	AAMTL
directionality	AAMTM
flames	AAMTN
spreading	AAMTO
hologram	AAMTP
BIG	AAMTQ
archetypes	AAMTR
multielement	AAMTS
PAT	AAMTT
aerobics	AAMTU
allen	AAMTV
theater	AAMTW
featuring	AAMTX
affective	AAMTY
billiards	AAMTZ
exaggerated	AAMUA
willow	AAMUB
physiological	AAMUC
frustration	AAMUD
unencumbered	AAMUE
305	AAMUF
staying	AAMUG
alive	AAMUH
conf	AAMUI
labeled	AAMUJ
recovered	AAMUK
computed	AAMUL
each	AAMUM
unsmearing	AAMUN
isomor	AAMUO
phism	AAMUP
movies	AAMUQ
hearing	AAMUR
exloration	AAMUS
bonuses	AAMUT
mackey	AAMUU
25	AAMUV
minus	AAMUW
semilinear	AAMUX
produces	AAMUY
elfadel	AAMUZ
aura	AAMVA
lena	AAMVB
studios	AAMVC
tv	AAMVD
volatile	AAMVE
bicubic	AAMVF
hermite	AAMVG
halftoning	AAMVH
ProbCut	AAMVI
cottage	AAMVJ
industry	AAMVK
leaves	AAMVL
biorthogonal	AAMVM
nomadic	AAMVN
spatialized	AAMVO
activating	AAMVP
FERET	AAMVQ
azimuth	AAMVR
elevation	AAMVS
interaural	AAMVT
breakdown	AAMVU
IPUS	AAMVV
polyphonic	AAMVW
recordings	AAMVX
recorded	AAMVY
typeset	AAMVZ
KERMODE	AAMWA
negotiated	AAMWB
reection	AAMWC
telecollaboration	AAMWD
MZAP	AAMWE
consumer	AAMWF
amalthaea	AAMWG
nonnegative	AAMWH
listening	AAMWI
nitin	AAMWJ
eigenvalues	AAMWK
columbia	AAMWL
coil	AAMWM
pronoun	AAMWN
referent	AAMWO
inscrib	AAMWP
trivalent	AAMWQ
conjoint	AAMWR
subband	AAMWS
NYU	AAMWT
tilt	AAMWU
aftereffect	AAMWV
fetching	AAMWW
shells	AAMWX
intersections	AAMWY
proved	AAMWZ
hypertextual	AAMXA
ff	AAMXB
IDEA	AAMXC
recurrence	AAMXD
polices	AAMXE
preservation	AAMXF
evolveable	AAMXG
CalTech	AAMXH
23	AAMXI
helmet	AAMXJ
coplanarity	AAMXK
shastra	AAMXL
ware	AAMXM
lingua	AAMXN
franca	AAMXO
structurally	AAMXP
increased	AAMXQ
CAGD	AAMXR
cloning	AAMXS
renaissance	AAMXT
geometrically	AAMXU
AAPC	AAMXV
foveating	AAMXW
phylogenetic	AAMXX
ordinal	AAMXY
mol	AAMXZ
nonstructural	AAMYA
noncooperative	AAMYB
provision	AAMYC
burstiness	AAMYD
solids	AAMYE
freeform	AAMYF
patch	AAMYG
biquartic	AAMYH
bernstein	AAMYI
bezier	AAMYJ
homeomorphisms	AAMYK
metamorphosis	AAMYL
exchanges	AAMYM
backface	AAMYN
temproally	AAMYO
toniolo	AAMYP
csg	AAMYQ
depoissonization	AAMYR
coplanar	AAMYS
unwarping	AAMYT
nonoverlapping	AAMYU
PDEs	AAMYV
appending	AAMYW
la	AAMYX
grange	AAMYY
multipliers	AAMYZ
urban	AAMZA
according	AAMZB
drifting	AAMZC
fpga	AAMZD
trigram	AAMZE
op	AAMZF
timal	AAMZG
analyse	AAMZH
discretizations	AAMZI
acceptability	AAMZJ
cascadic	AAMZK
iterations	AAMZL
migrant	AAMZM
farms	AAMZN
ariadne	AAMZO
EcliPSe	AAMZP
saving	AAMZQ
parasol	AAMZR
compliant	AAMZS
fastner	AAMZT
operationg	AAMZU
fish	AAMZV
tank	AAMZW
analysing	AAMZX
residency	AAMZY
check	AAMZZ
affecting	AANAA
touchstone	AANAB
CRAY	AANAC
ellpack	AANAD
pde	AANAE
ELLPACK	AANAF
SciAgents	AANAG
SciencePad	AANAH
notepad	AANAI
robiological	AANAJ
PYTHIA	AANAK
teleoperation	AANAL
vibration	AANAM
MESSIAHS	AANAN
pub	AANAO
lically	AANAP
troff	AANAQ
nroff	AANAR
taxonomies	AANAS
scanner	AANAT
viruses	AANAU
fringing	AANAV
consideration	AANAW
maple	AANAX
nspcg	AANAY
blockabil	AANAZ
SoftLab	AANBA
assess	AANBB
transmitting	AANBC
living	AANBD
topass	AANBE
limitation	AANBF
animal	AANBG
crossword	AANBH
precondi	AANBI
tioners	AANBJ
c**	AANBK
SP2	AANBL
momenta	AANBM
neocortical	AANBN
reannealing	AANBO
combat	AANBP
barnhill	AANBQ
bond	AANBR
changer	AANBS
CFS	AANBT
involves	AANBU
ellman	AANBV
allegro	AANBW
cf	AANBX
iterates	AANBY
walsh	AANBZ
p8	AANCA
inlets	AANCB
deja	AANCC
vu	AANCD
fixpoints	AANCE
stratification	AANCF
DATALOG	AANCG
coral++	AANCH
initializability	AANCI
briefing	AANCJ
semicontinuity	AANCK
WEAVER	AANCL
capital	AANCM
investment	AANCN
marvel	AANCO
PCTE	AANCP
OMS	AANCQ
lexically	AANCR
discrepancy	AANCS
14778	AANCT
pedagogical	AANCU
insights	AANCV
integrals	AANCW
finance	AANCX
valuation	AANCY
valuing	AANCZ
pseu	AANDA
doserver	AANDB
intermingling	AANDC
isochronet	AANDD
fishing	AANDE
researchers	AANDF
piloting	AANDG
centre	AANDH
solvable	AANDI
overcome	AANDJ
algorithmics	AANDK
ACID	AANDL
relief	AANDM
autonomy	AANDN
tuple	AANDO
meldc	AANDP
reorganization	AANDQ
ulam	AANDR
lies	AANDS
systemsa	AANDT
kuratowski	AANDU
IBC	AANDV
BGP	AANDW
flap	AANDX
damping	AANDY
idr	AANDZ
damp	AANEA
SPLENDORS	AANEB
octree	AANEC
marchin	AANED
decoherence	AANEE
inaccuracies	AANEF
defocus	AANEG
CLIQUES	AANEH
microscopic	AANEI
labor	AANEJ
gale	AANEK
shapley	AANEL
MASC	AANEM
BGMP	AANEN
seeing	AANEO
flexibly	AANEP
instructable	AANEQ
cords	AANER
baby	AANES
telephony	AANET
antennas	AANEU
dimensionality	AANEV
eigenspace	AANEW
CUCS	AANEX
021	AANEY
SLAM	AANEZ
ARPACK	AANFA
groupwise	AANFB
audit	AANFC
SWORD	AANFD
missile	AANFE
constructivist	AANFF
residues	AANFG
hindsight	AANFH
EQuipartitioning	AANFI
demeter	AANFJ
dependability	AANFK
herreweghen	AANFL
transformer	AANFM
tunnels	AANFN
normative	AANFO
calculating	AANFP
carry	AANFQ
neurophysiological	AANFR
contravariance	AANFS
curricula	AANFT
LINK	AANFU
scenarios	AANFV
healthcare	AANFW
PRS	AANFX
segregatory	AANFY
civil	AANFZ
angle	AANGA
distributing	AANGB
filtereing	AANGC
usenet	AANGD
guards	AANGE
russian	AANGF
regret	AANGG
matting	AANGH
olympics	AANGI
polymer	AANGJ
conformation	AANGK
tiles	AANGL
nonstandard	AANGM
WorldWide	AANGN
intranet	AANGO
sychronization	AANGP
representatives	AANGQ
rap	AANGR
arithmetical	AANGS
basu	AANGT
summation	AANGU
escaping	AANGV
guis	AANGW
multiset	AANGX
whence	AANGY
whither	AANGZ
adjustment	AANHA
enriched	AANHB
internet97	AANHC
exactly	AANHD
migratable	AANHE
intermittently	AANHF
chromatic	AANHG
CALYPSO	AANHH
goes	AANHI
nfa	AANHJ
preprints	AANHK
semidirect	AANHL
willard	AANHM
InterGroup	AANHN
BVPs	AANHO
coalitions	AANHP
hypergraphs	AANHQ
rutcor	AANHR
22	AANHS
nucleotide	AANHT
accurately	AANHU
reconstruct	AANHV
predicative	AANHW
shock	AANHX
ICP	AANHY
squid	AANHZ
extensional	AANIA
finitely	AANIB
disc	AANIC
polycyclic	AANID
dawn	AANIE
breslauer	AANIF
crochemore	AANIG
perrin	AANIH
ICC++	AANII
ParaSight	AANIJ
PostMortem	AANIK
quartet	AANIL
splits	AANIM
infer	AANIN
dyadic	AANIO
quartets	AANIP
SUMMARIST	AANIQ
unfilled	AANIR
pauses	AANIS
legion	AANIT
nuclearity	AANIU
interation	AANIV
specify	AANIW
facets	AANIX
persuasive	AANIY
achilles	AANIZ
heel	AANJA
flip	AANJB
restriction	AANJC
owned	AANJD
swept	AANJE
calligraphic	AANJF
amateur	AANJG
declining	AANJH
dualities	AANJI
concordant	AANJJ
goodness	AANJK
circle	AANJL
isometry	AANJM
hadamard	AANJN
condensing	AANJO
NonMetric	AANJP
positions	AANJQ
spellbinding	AANJR
adjunct	AANJS
dreyer	AANJT
overton	AANJU
editing	AANJV
foveation	AANJW
thinwire	AANJX
interchangeability	AANJY
supports	AANJZ
rolap	AANKA
cubetrees	AANKB
bushy	AANKC
alto	AANKD
sisal	AANKE
schooner	AANKF
AVS	AANKG
biosequences	AANKH
sfi	AANKI
multimodel	AANKJ
chand	AANKK
misra	AANKL
byrant	AANKM
calculation	AANKN
identically	AANKO
multimodeling	AANKP
partioned	AANKQ
zsparse	AANKR
interruptible	AANKS
compartment	AANKT
redoing	AANKU
commands	AANKV
dichotomy	AANKW
routabil	AANKX
cooperatively	AANKY
upgrading	AANKZ
vertices	AANLA
fishwick	AANLB
DLAB	AANLC
mst	AANLD
relaible	AANLE
simplest	AANLF
noising	AANLG
connect	AANLH
wins	AANLI
classificatory	AANLJ
russians	AANLK
scoring	AANLL
clones	AANLM
probe	AANLN
microwave	AANLO
267	AANLP
contingencies	AANLQ
microcomputer	AANLR
IDeal	AANLS
IDRA	AANLT
speedups	AANLU
conjunto	AANLV
divergence	AANLW
brainwashing	AANLX
trap	AANLY
breakpoint	AANLZ
relocating	AANMA
currying	AANMB
minefield	AANMC
tsp	AANMD
late	AANME
cogency	AANMF
DestinationSequenced	AANMG
DSDV	AANMH
CANDY	AANMI
articulator	AANMJ
synthesizer	AANMK
FDDI	AANML
WAN	AANMM
campus	AANMN
teleservices	AANMO
degradation	AANMP
gbit/second	AANMQ
addison	AANMR
wesley	AANMS
ICS	AANMT
broswer	AANMU
perceptions	AANMV
microstructure	AANMW
electrostatics	AANMX
startt	AANMY
voyager	AANMZ
CSG	AANNA
387	AANNB
unparsing	AANNC
postfix	AANND
boldly	AANNE
gone	AANNF
TargetSensitive	AANNG
regulation	AANNH
ramanujan	AANNI
billion	AANNJ
polylogarithmic	AANNK
defunc	AANNL
tionalization	AANNM
year	AANNN
census	AANNO
metaml	AANNP
multiuser	AANNQ
questionnaire	AANNR
extendible	AANNS
battle	AANNT
contribution	AANNU
consonants	AANNV
vowels	AANNW
fluent	AANNX
reynold	AANNY
defunctionalization	AANNZ
centrally	AANOA
encapsulate	AANOB
fleet	AANOC
idealized	AANOD
MetaML	AANOE
ascii	AANOF
symbols	AANOG
catch	AANOH
department	AANOI
mediation	AANOJ
berk	AANOK
bhattacharyya	AANOL
room	AANOM
mellin	AANON
MSL	AANOO
GlOSS	AANOP
telepresence	AANOQ
unnecessary	AANOR
fuzziness	AANOS
coach	AANOT
listens	AANOU
oral	AANOV
tan	AANOW
WAXHOLM	AANOX
defintions	AANOY
byte	AANOZ
laboratories	AANPA
city	AANPB
lamm	AANPC
autopilot	AANPD
labeler	AANPE
diom	AANPF
cq	AANPG
unsteady	AANPH
compressible	AANPI
navier	AANPJ
transonic	AANPK
death	AANPL
taxes	AANPM
inevitable	AANPN
overflow	AANPO
convection	AANPP
water	AANPQ
SUPRENUM	AANPR
identify	AANPS
jets	AANPT
nucl	AANPU
gluon	AANPV
warm	AANPW
catas	AANPX
VIPR	AANPY
expanding	AANPZ
microsimulation	AANQA
lesson	AANQB
SUIT	AANQC
sonification	AANQD
payoffs	AANQE
pitfalls	AANQF
memoization	AANQG
SDRR	AANQH
degraded	AANQI
PROTEUS	AANQJ
switchboard	AANQK
manuscripts	AANQL
uncovering	AANQM
authors	AANQN
proteins	AANQO
cars	AANQP
gating	AANQQ
grand	AANQR
becoming	AANQS
increasingly	AANQT
och	AANQU
sybil	AANQV
alliances	AANQW
nonconforming	AANQX
epidemic	AANQY
broaden	AANQZ
locked	AANRA
callbacks	AANRB
callee	AANRC
save	AANRD
SAMOS	AANRE
buses	AANRF
fun	AANRG
MUDs	AANRH
readings	AANRI
concur	AANRJ
rency	AANRK
finitary	AANRL
parallelismon	AANRM
popular	AANRN
SCALE	AANRO
served	AANRP
functionally	AANRQ
yacht	AANRR
MSG	AANRS
auotmated	AANRT
heat	AANRU
DOMS	AANRV
javar	AANRW
origin	AANRX
graduated	AANRY
defered	AANRZ
SuperLU	AANSA
scoped	AANSB
doctor	AANSC
immobile	AANSD
thirteenth	AANSE
EMMCVPR	AANSF
panel	AANSG
strengthens	AANSH
disruptive	AANSI
laminated	AANSJ
rotationally	AANSK
quasiconvex	AANSL
FORR	AANSM
theses	AANSN
taxonomic	AANSO
SuchThat	AANSP
epiq	AANSQ
brokerage	AANSR
justified	AANSS
genereal	AANST
adaptable	AANSU
icc++	AANSV
STEP	AANSW
bimodal	AANSX
di	AANSY
CTOL	AANSZ
food	AANTA
deploying	AANTB
softbots	AANTC
NPARC	AANTD
traps	AANTE
managemnt	AANTF
heterogenous	AANTG
emptiness	AANTH
standardizing	AANTI
mechatronic	AANTJ
SIOMS	AANTK
spackling	AANTL
trenches	AANTM
ways	AANTN
twin	AANTO
InterAct	AANTP
henderson	AANTQ
colvin	AANTR
dick	AANTS
valiquette	AANTT
allomorphy	AANTU
off++	AANTV
2k	AANTW
cedar	AANTX
pascal	AANTY
linearized	AANTZ
enhencement	AANUA
determinations	AANUB
thinking	AANUC
serpentine	AANUD
utilizes	AANUE
RSTA	AANUF
correctors	AANUG
crises	AANUH
wars	AANUI
KOSIMO	AANUJ
forty	AANUK
outlines	AANUL
vectorization	AANUM
skilled	AANUN
protective	AANUO
specifica	AANUP
dispatch	AANUQ
tuples	AANUR
802	AANUS
HRTF	AANUT
KEMAR	AANUU
utilitarian	AANUV
quaternion	AANUW
SSL	AANUX
goodrich	AANUY
contain	AANUZ
ramos	AANVA
metrology	AANVB
intention	AANVC
metatem	AANVD
GALAXY	AANVE
repsonse	AANVF
storing	AANVG
explosives	AANVH
DBMSs	AANVI
ans	AANVJ
trackers	AANVK
6r	AANVL
disposable	AANVM
textnet	AANVN
folded	AANVO
rtdb	AANVP
timely	AANVQ
tunneling	AANVR
faulting	AANVS
surgical	AANVT
hedge	AANVU
multiscalar	AANVV
footprints	AANVW
fifo	AANVX
corruption	AANVY
corba	AANVZ
exposed	AANWA
isosurfaces	AANWB
modality	AANWC
contrasting	AANWD
v3	AANWE
refernece	AANWF
isomorph	AANWG
thory	AANWH
REINAS	AANWI
bipartitioning	AANWJ
localist	AANWK
pickling	AANWL
question	AANWM
educational	AANWN
therapeutic	AANWO
researching	AANWP
rocchio	AANWQ
tfidf	AANWR
GAL	AANWS
grow	AANWT
shrink	AANWU
forget	AANWV
neuropathy	AANWW
neighborhoods	AANWX
WebWatcher	AANWY
het	AANWZ
erogeneous	AANXA
VRP	AANXB
multisource	AANXC
weber	AANXD
closures	AANXE
multipro	AANXF
cessors	AANXG
warped	AANXH
oscillation	AANXI
1992	AANXJ
ICMC	AANXK
174	AANXL
177	AANXM
HYDRA	AANXN
mm	AANXO
impementing	AANXP
sala	AANXQ
coax	AANXR
HAUTUS	AANXS
outputs	AANXT
smith	AANXU
predictor	AANXV
EPRCA	AANXW
ization	AANXX
innovation	AANXY
chart	AANXZ
oo	AANYA
tema	AANYB
variazioni	AANYC
railway	AANYD
interlockings	AANYE
ExSpect	AANYF
undiscounted	AANYG
potentially	AANYH
realizable	AANYI
pruhs	AANYJ
IFOR	AANYK
nature	AANYL
departure	AANYM
leaky	AANYN
ease	AANYO
lead	AANYP
PASSION	AANYQ
FaCT	AANYR
HERMES	AANYS
signalling	AANYT
fluents	AANYU
counterexamples	AANYV
baker	AANYW
proble	AANYX
preferably	AANYY
complexification	AANYZ
influences	AANZA
endstations	AANZB
teranode	AANZC
VOD	AANZD
vod	AANZE
provide	AANZF
encoded	AANZG
rightful	AANZH
ownership	AANZI
berke	AANZJ
ley	AANZK
gains	AANZL
MINOS	AANZM
nonminimum	AANZN
undistorted	AANZO
licientiate	AANZP
philosophy	AANZQ
tanenbaum	AANZR
indeterminate	AANZS
terminating	AANZT
mutagenesis	AANZU
volitional	AANZV
stories	AANZW
EXP	AANZX
interestingness	AANZY
roots	AANZZ
comparision	AAOAA
flightless	AAOAB
birds	AAOAC
mermera	AAOAD
transcribing	AAOAE
matte	AAOAF
spert	AAOAG
diffuse	AAOAH
liver	AAOAI
echography	AAOAJ
tjoa	AAOAK
gerti	AAOAL
kappel	AAOAM
sotware	AAOAN
tabulated	AAOAO
disagreements	AAOAP
kritik	AAOAQ
maher	AAOAR
pu	AAOAS
subsys	AAOAT
XPVM	AAOAU
screens	AAOAV
fire	AAOAW
truck	AAOAX
debate	AAOAY
nonapproximability	AAOAZ
encyclopaedia	AAOBA
actors	AAOBB
MDPs	AAOBC
gofer	AAOBD
kaleidoscope90	AAOBE
lan	AAOBF
needham	AAOBG
schroeder	AAOBH
ASA	AAOBI
reflectometry	AAOBJ
broyden	AAOBK
terminates	AAOBL
semirings	AAOBM
211	AAOBN
autonomously	AAOBO
moderate	AAOBP
quadratically	AAOBQ
fixture	AAOBR
KDD	AAOBS
EuroPlop97	AAOBT
configurer	AAOBU
replicator	AAOBV
tour	AAOBW
PRODIGY	AAOBX
ADT	AAOBY
parsimony	AAOBZ
kuokka	AAOCA
balancers	AAOCB
RAM	AAOCC
previewing	AAOCD
representational	AAOCE
wrap	AAOCF
destructive	AAOCG
kubat	AAOCH
virtues	AAOCI
conferences	AAOCJ
multiparticipant	AAOCK
informal	AAOCL
acti	AAOCM
onal	AAOCN
marginal	AAOCO
contemporaneous	AAOCP
tiny	AAOCQ
seems	AAOCR
kiloprocessor	AAOCS
preferred	AAOCT
ISSTA96	AAOCU
blended	AAOCV
hydrodynamic	AAOCW
preconditions	AAOCX
postconditions	AAOCY
provisional	AAOCZ
cascor	AAODA
pacs	AAODB
CoRE	AAODC
SCR	AAODD
regulated	AAODE
realities	AAODF
halfspaces	AAODG
intraprocess	AAODH
kind	AAODI
neuronal	AAODJ
coincidence	AAODK
PCA	AAODL
spatia	AAODM
FACS	AAODN
miss	AAODO
dominator	AAODP
flowgraph	AAODQ
MMU	AAODR
antipenumbra	AAODS
simplifi	AAODT
cation	AAODU
explained	AAODV
neurocomputing	AAODW
RAP	AAODX
stretch	AAODY
serach	AAODZ
thermodynamic	AAOEA
